,index,Scratched,Breakage,Separated,Crushed,total_anns,ran_var,dataset
0,0510133_sc-227221.jpg,2,0,0,0,2,0,train
1,0510130_sc-214980.jpg,2,1,0,0,3,0,train
2,0510131_sc-214980.jpg,1,1,0,0,2,0,train
3,0510109_sc-141778.jpg,1,1,1,0,3,0,train
4,0510128_sc-214980.jpg,1,0,0,0,1,0,train
5,0510108_sc-141399.jpg,2,0,0,0,2,0,val
6,0510104_sc-207575.jpg,1,0,0,0,1,0,test
7,0510123_sc-214980.jpg,1,1,1,0,3,0,train
8,0510119_sc-214980.jpg,3,2,1,0,6,0,train
9,0510143_sc-1007005.jpg,2,0,0,0,2,0,train
10,0510081_sc-1033716.jpg,8,0,0,0,8,0,train
11,0510096_sc-190011.jpg,2,0,0,0,2,0,train
12,0510106_sc-207575.jpg,2,0,1,0,3,0,val
13,0510126_sc-214980.jpg,2,0,0,0,2,0,test
14,0510080_sc-1033716.jpg,0,0,1,0,1,0,train
15,0510142_sc-1007005.jpg,1,0,0,0,1,0,train
16,0510091_as-0017167.jpg,1,0,0,0,1,0,train
17,0510136_as-0079871.jpg,4,0,0,0,4,0,train
18,0510125_sc-214980.jpg,4,2,1,0,7,0,train
19,0510098_sc-107254.jpg,9,0,0,1,10,0,val
20,0510105_sc-207575.jpg,3,0,2,0,5,0,test
21,0510118_as-3092881.jpg,1,0,1,0,2,0,train
22,0510121_sc-214980.jpg,2,0,0,0,2,0,train
23,0510146_sc-223802.jpg,2,0,1,0,3,0,train
24,0510127_sc-214980.jpg,0,1,0,1,2,0,train
25,0510078_sc-1033716.jpg,2,0,0,0,2,0,train
26,0510114_sc-1008558.jpg,0,1,0,0,1,0,val
27,0510145_sc-223802.jpg,3,0,0,2,5,0,test
28,0510140_as-0079871.jpg,2,0,0,0,2,0,train
29,0510093_as-0017167.jpg,1,0,0,1,2,0,train
30,0510148_sc-223802.jpg,2,0,2,0,4,0,train
31,0510135_as-0079871.jpg,12,0,0,0,12,0,train
32,0510097_sc-197234.jpg,1,0,0,1,2,0,train
33,0510107_sc-207575.jpg,3,0,0,0,3,0,val
34,0510089_as-2832716.jpg,1,1,1,0,3,0,test
35,0510086_as-3145667.jpg,1,0,1,0,2,0,train
36,0510147_sc-223802.jpg,3,0,0,0,3,0,train
37,0510139_as-0079871.jpg,4,0,0,0,4,0,train
38,0510144_sc-223802.jpg,3,0,0,0,3,0,train
39,0510120_sc-214980.jpg,1,1,0,0,2,0,train
40,0510122_sc-214980.jpg,1,0,1,0,2,0,val
41,0510124_sc-214980.jpg,1,0,0,0,1,0,test
42,0510115_as-2652263.jpg,2,0,0,0,2,0,train
43,0510092_as-0017167.jpg,3,0,0,0,3,0,train
44,0510129_sc-214980.jpg,0,1,0,0,1,0,train
45,0510110_sc-141778.jpg,5,0,0,0,5,0,train
46,0510134_sc-227221.jpg,1,0,0,0,1,0,train
47,0510084_as-2918519.jpg,3,0,0,1,4,0,val
48,0510113_sc-1008558.jpg,2,0,1,0,3,0,test
49,0510088_as-0076021.jpg,1,0,0,0,1,0,train
50,0510103_as-0006435.jpg,1,0,1,0,2,0,train
51,0510090_as-2520130.jpg,4,0,1,0,5,0,train
52,0510077_as-9048801.jpg,3,0,0,0,3,0,train
53,0510116_sc-216347.jpg,1,0,0,0,1,0,train
54,0510111_sc-119291.jpg,4,0,1,0,5,0,val
55,0510132_sc-227221.jpg,0,0,1,0,1,0,test
56,0510094_as-2599621.jpg,1,1,0,0,2,0,train
57,0510082_sc-1033716.jpg,0,0,1,1,2,0,train
58,0510099_sc-107254.jpg,4,3,1,1,9,0,train
59,0510213_as-0015909.jpg,2,0,0,1,3,0,train
60,0510198_as-0047697.jpg,4,0,0,0,4,0,train
61,0510177_sc-205207.jpg,1,0,0,0,1,0,val
62,0510149_as-0068061.jpg,2,0,0,0,2,0,test
63,0510161_as-0067788.jpg,1,0,0,0,1,0,train
64,0510189_as-3429785.jpg,3,0,0,0,3,0,train
65,0510181_as-0083183.jpg,1,0,1,1,3,0,train
66,0510167_sc-1033410.jpg,0,0,1,0,1,0,train
67,0510169_sc-1033410.jpg,1,0,0,0,1,0,train
68,0510205_as-0073463.jpg,1,0,1,0,2,0,val
69,0510196_as-0047697.jpg,1,0,0,1,2,0,test
70,0510172_sc-213650.jpg,1,0,0,3,4,0,train
71,0510209_sc-212816.jpg,3,0,0,0,3,0,train
72,0510154_as-0068061.jpg,4,0,1,0,5,0,train
73,0510188_sc-193661.jpg,0,1,1,0,2,0,train
74,0510184_sc-187364.jpg,1,0,0,0,1,0,train
75,0510185_sc-193661.jpg,3,0,0,2,5,0,val
76,0510180_as-0083183.jpg,1,0,2,0,3,0,test
77,0510208_sc-212816.jpg,1,0,0,1,2,0,train
78,0510162_as-0067788.jpg,1,0,0,0,1,0,train
79,0510164_as-7215585.jpg,2,2,1,1,6,0,train
80,0510192_as-0018761.jpg,0,0,1,0,1,0,train
81,0510197_as-0047697.jpg,1,0,0,0,1,0,train
82,0510195_as-0018761.jpg,2,0,1,0,3,0,val
83,0510166_sc-1033410.jpg,15,0,0,0,15,0,test
84,0510170_sc-1033410.jpg,1,0,0,0,1,0,train
85,0510206_sc-212816.jpg,1,0,0,0,1,0,train
86,0510183_as-3195924.jpg,18,0,0,0,18,0,train
87,0510194_as-0018761.jpg,5,0,0,0,5,0,train
88,0510168_sc-1033410.jpg,1,0,0,1,2,0,train
89,0510159_as-0094895.jpg,1,0,1,0,2,0,val
90,0510182_as-0083183.jpg,2,0,0,0,2,0,test
91,0510179_as-0083183.jpg,3,1,1,1,6,0,train
92,0510171_as-3373567.jpg,1,0,0,0,1,0,train
93,0510193_as-0018761.jpg,1,1,0,0,2,0,train
94,0510156_as-0020099.jpg,1,0,0,0,1,0,train
95,0510187_sc-193661.jpg,2,0,0,0,2,0,train
96,0510160_as-0067788.jpg,2,0,0,0,2,0,val
97,0510152_as-0068061.jpg,1,1,0,0,2,0,test
98,0510153_as-0068061.jpg,2,0,0,0,2,0,train
99,0510214_as-0015909.jpg,3,2,0,1,6,0,train
100,0510174_sc-205207.jpg,5,0,0,0,5,0,train
101,0510186_sc-193661.jpg,7,0,0,1,8,0,train
102,0510158_sc-125822.jpg,3,0,0,0,3,0,train
103,0510175_sc-205207.jpg,1,0,0,0,1,0,val
104,0510173_sc-213650.jpg,2,0,0,1,3,0,test
105,0510176_sc-205207.jpg,2,0,0,0,2,0,train
106,0510199_as-0047697.jpg,2,0,0,1,3,0,train
107,0510207_sc-212816.jpg,1,1,0,3,5,0,train
108,0510268_as-0042050.jpg,2,0,0,0,2,0,train
109,0510294_as-3369090.jpg,2,0,0,0,2,0,train
110,0510257_sc-182654.jpg,1,0,0,0,1,0,val
111,0510267_as-0042050.jpg,4,0,1,0,5,0,test
112,0510247_sc-106690.jpg,1,0,1,0,2,0,train
113,0510279_as-2953372.jpg,2,0,0,0,2,0,train
114,0510300_sc-104578.jpg,2,0,0,0,2,0,train
115,0510237_as-0013813.jpg,2,0,0,0,2,0,train
116,0510232_as-0013813.jpg,1,1,0,0,2,0,train
117,0510243_as-7250211.jpg,1,1,1,0,3,0,val
118,0510272_as-0043893.jpg,5,0,0,0,5,0,test
119,0510239_as-0013813.jpg,1,0,0,0,1,0,train
120,0510309_as-0034364.jpg,2,0,0,0,2,0,train
121,0510296_sc-174845.jpg,1,1,1,0,3,0,train
122,0510280_sc-1003199.jpg,1,0,1,0,2,0,train
123,0510228_sc-1022129.jpg,4,0,0,0,4,0,train
124,0510217_as-0015909.jpg,1,0,0,0,1,0,val
125,0510219_as-0015909.jpg,1,0,1,0,2,0,test
126,0510224_sc-1022129.jpg,1,0,0,0,1,0,train
127,0510284_sc-1023264.jpg,1,0,1,1,3,0,train
128,0510262_as-0046020.jpg,1,0,1,0,2,0,train
129,0510249_sc-106690.jpg,3,0,0,0,3,0,train
130,0510220_as-0015909.jpg,1,2,0,0,3,0,train
131,0510255_sc-106690.jpg,1,0,0,0,1,0,val
132,0510281_sc-1003199.jpg,5,0,1,0,6,0,test
133,0510285_sc-1023264.jpg,1,0,0,0,1,0,train
134,0510256_sc-106690.jpg,6,0,0,0,6,0,train
135,0510293_sc-192619.jpg,1,0,0,0,1,0,train
136,0510277_as-3308746.jpg,2,0,1,0,3,0,train
137,0510311_as-3001061.jpg,3,0,0,0,3,0,train
138,0510283_sc-1023264.jpg,6,1,1,0,8,0,val
139,0510289_sc-1023264.jpg,1,0,0,0,1,0,test
140,0510245_sc-106690.jpg,7,0,1,1,9,0,train
141,0510310_as-0070146.jpg,1,0,0,0,1,0,train
142,0510276_as-2805965.jpg,1,0,0,1,2,0,train
143,0510304_as-0096586.jpg,1,0,1,0,2,0,train
144,0510238_as-0013813.jpg,1,0,1,0,2,0,train
145,0510273_as-0043893.jpg,0,2,1,0,3,0,val
146,0510248_sc-106690.jpg,1,0,0,0,1,0,test
147,0510263_as-2552879.jpg,1,0,0,0,1,0,train
148,0510307_as-0034364.jpg,5,0,0,0,5,0,train
149,0510306_as-0096586.jpg,2,0,0,0,2,0,train
150,0510252_sc-106690.jpg,2,0,0,1,3,0,train
151,0510298_sc-104578.jpg,1,0,1,0,2,0,train
152,0510302_as-0096586.jpg,3,0,0,0,3,0,val
153,0510223_sc-1022129.jpg,4,0,0,0,4,0,test
154,0510240_as-0013813.jpg,1,0,0,0,1,0,train
155,0510242_sc-187267.jpg,7,0,1,0,8,0,train
156,0510287_sc-1023264.jpg,2,0,1,1,4,0,train
157,0510259_as-0046020.jpg,2,2,1,0,5,0,train
158,0510234_as-0013813.jpg,1,1,2,0,4,0,train
159,0510292_sc-192619.jpg,2,1,0,0,3,0,val
160,0510291_sc-192619.jpg,2,0,0,0,2,0,test
161,0510308_as-0034364.jpg,4,2,2,0,8,0,train
162,0510312_as-3001061.jpg,1,0,0,0,1,0,train
163,0510297_as-3321495.jpg,2,0,1,0,3,0,train
164,0510270_as-0042050.jpg,2,0,0,0,2,0,train
165,0510278_as-2788983.jpg,1,0,0,0,1,0,train
166,0510254_sc-106690.jpg,4,1,0,0,5,0,val
167,0510250_sc-106690.jpg,1,0,1,0,2,0,test
168,0510235_as-0013813.jpg,9,3,2,0,14,0,train
169,0510271_as-0043893.jpg,1,0,0,0,1,0,train
170,0510231_as-0013813.jpg,0,1,0,0,1,0,train
171,0510236_as-0013813.jpg,2,0,0,0,2,0,train
172,0510215_as-0015909.jpg,3,0,0,1,4,0,train
173,0510246_sc-106690.jpg,1,0,2,0,3,0,val
174,0510221_sc-1022129.jpg,2,0,0,1,3,0,test
175,0510288_sc-1023264.jpg,5,5,2,0,12,0,train
176,0510218_as-0015909.jpg,1,0,1,0,2,0,train
177,0510216_as-0015909.jpg,1,0,0,1,2,0,train
178,0510233_as-0013813.jpg,1,0,0,0,1,0,train
179,0510251_sc-106690.jpg,1,0,0,0,1,0,train
180,0510253_sc-106690.jpg,2,0,0,0,2,0,val
181,0510222_sc-1022129.jpg,4,0,1,1,6,0,test
182,0510260_as-0046020.jpg,1,0,0,1,2,0,train
183,0510274_as-0069034.jpg,2,1,0,1,4,0,train
184,0510244_sc-109284.jpg,1,0,0,0,1,0,train
185,0510226_sc-1022129.jpg,1,0,0,0,1,0,train
186,0510299_sc-104578.jpg,3,1,1,2,7,0,train
187,0510305_as-0096586.jpg,3,0,0,0,3,0,val
188,0510241_sc-187267.jpg,5,0,0,0,5,0,test
189,0510275_as-0069034.jpg,1,0,0,0,1,0,train
190,0510340_as-2516567.jpg,5,2,1,0,8,0,train
191,0510351_sc-224047.jpg,10,0,0,3,13,0,train
192,0510344_sc-222018.jpg,1,0,0,0,1,0,train
193,0510375_sc-141322.jpg,1,0,0,0,1,0,train
194,0510355_as-0092530.jpg,1,2,1,0,4,0,val
195,0510327_as-0036577.jpg,1,0,0,0,1,0,test
196,0510321_as-0072653.jpg,1,0,1,1,3,0,train
197,0510318_as-2613257.jpg,2,0,1,1,4,0,train
198,0510370_sc-141322.jpg,2,0,4,3,9,0,train
199,0510347_sc-222018.jpg,3,0,0,0,3,0,train
200,0510345_sc-222018.jpg,6,1,0,0,7,0,train
201,0510357_sc-133013.jpg,1,0,1,0,2,0,val
202,0510322_as-0072653.jpg,3,0,0,0,3,0,test
203,0510372_sc-141322.jpg,2,0,0,0,2,0,train
204,0510324_as-0036577.jpg,2,0,0,0,2,0,train
205,0510341_as-3451655.jpg,1,0,0,0,1,0,train
206,0510373_sc-141322.jpg,1,0,0,0,1,0,train
207,0510323_as-0072653.jpg,3,0,0,1,4,0,train
208,0510316_as-0039822.jpg,2,2,0,0,4,0,val
209,0510353_as-0092530.jpg,1,0,0,0,1,0,test
210,0510350_sc-224047.jpg,1,0,0,2,3,0,train
211,0510366_as-7273141.jpg,2,0,1,1,4,0,train
212,0510349_sc-224047.jpg,1,2,0,0,3,0,train
213,0510363_sc-133013.jpg,0,0,1,1,2,0,train
214,0510361_sc-133013.jpg,1,0,0,1,2,0,train
215,0510369_as-0001977.jpg,0,0,1,0,1,0,val
216,0510328_as-0036577.jpg,1,0,0,0,1,0,test
217,0510348_sc-224047.jpg,1,0,2,0,3,0,train
218,0510364_sc-133013.jpg,0,0,1,1,2,0,train
219,0510320_as-0072653.jpg,3,0,0,1,4,0,train
220,0510319_as-2980376.jpg,2,1,1,1,5,0,train
221,0510331_as-0036577.jpg,1,1,2,0,4,0,train
222,0510374_sc-141322.jpg,1,0,0,1,2,0,val
223,0510352_sc-224047.jpg,1,1,1,1,4,0,test
224,0510326_as-0036577.jpg,5,0,0,0,5,0,train
225,0510325_as-0036577.jpg,1,0,1,0,2,0,train
226,0510317_as-3150902.jpg,1,0,0,0,1,0,train
227,0510332_as-0036577.jpg,0,4,0,0,4,0,train
228,0510333_as-0036577.jpg,2,0,1,1,4,0,train
229,0510337_as-0073388.jpg,2,1,2,1,6,0,val
230,0510354_as-0092530.jpg,0,1,2,0,3,0,test
231,0510371_sc-141322.jpg,4,1,0,0,5,0,train
232,0510330_as-0036577.jpg,0,1,0,0,1,0,train
233,0510342_sc-222018.jpg,3,0,0,1,4,0,train
234,0510313_as-0039822.jpg,1,0,0,0,1,0,train
235,0510346_sc-222018.jpg,1,0,0,0,1,0,train
236,0510343_sc-222018.jpg,1,0,0,0,1,0,val
237,0510365_sc-133013.jpg,4,0,0,1,5,0,test
238,0510338_as-0073388.jpg,3,0,0,1,4,0,train
239,0510377_as-2826718.jpg,2,0,0,0,2,0,train
240,0510356_as-0092530.jpg,1,0,0,2,3,0,train
241,0510339_as-2631427.jpg,2,1,0,0,3,0,train
242,0510368_as-0001977.jpg,3,2,2,1,8,0,train
243,0510367_as-0001977.jpg,2,0,0,1,3,0,val
244,0510399_sc-195957.jpg,0,0,0,1,1,0,test
245,0510421_as-4618439.jpg,2,0,1,0,3,0,train
246,0510427_sc-222149.jpg,2,0,1,2,5,0,train
247,0510451_sc-1005082.jpg,1,0,0,0,1,0,train
248,0510390_sc-156424.jpg,7,2,4,1,14,0,train
249,0510392_sc-156424.jpg,2,0,0,0,2,0,train
250,0510385_as-0019006.jpg,1,0,1,1,3,0,val
251,0510428_sc-222149.jpg,1,1,0,1,3,0,test
252,0510425_as-2799240.jpg,2,3,6,1,12,0,train
253,0510383_as-0019006.jpg,0,0,1,0,1,0,train
254,0510426_sc-222149.jpg,3,1,1,0,5,0,train
255,0510396_sc-1004931.jpg,3,0,1,1,5,0,train
256,0510409_sc-205872.jpg,2,1,2,0,5,0,train
257,0510462_as-0041411.jpg,2,0,0,0,2,0,val
258,0510408_as-2512122.jpg,1,0,0,0,1,0,test
259,0510423_as-0058563.jpg,3,0,0,0,3,0,train
260,0510417_as-0026101.jpg,3,0,1,0,4,0,train
261,0510455_sc-209152.jpg,1,0,1,0,2,0,train
262,0510434_as-0006689.jpg,1,0,0,0,1,0,train
263,0510458_sc-209152.jpg,3,1,1,0,5,0,train
264,0510443_as-0001901.jpg,0,1,0,0,1,0,val
265,0510397_sc-195957.jpg,1,0,0,0,1,0,test
266,0510401_sc-195957.jpg,3,2,1,0,6,0,train
267,0510464_sc-156205.jpg,0,2,0,1,3,0,train
268,0510424_as-2628653.jpg,1,0,1,0,2,0,train
269,0510394_sc-1004931.jpg,1,0,1,0,2,0,train
270,0510447_as-9045921.jpg,0,2,0,1,3,0,train
271,0510445_as-7328681.jpg,1,0,1,0,2,0,val
272,0510454_sc-209152.jpg,3,0,0,0,3,0,test
273,0510410_sc-205872.jpg,2,0,1,1,4,0,train
274,0510412_sc-1006781.jpg,2,0,0,0,2,0,train
275,0510386_sc-156424.jpg,5,1,1,1,8,0,train
276,0510453_sc-209152.jpg,1,0,0,0,1,0,train
277,0510391_sc-156424.jpg,2,0,1,1,4,0,train
278,0510433_sc-1041768.jpg,2,0,0,0,2,0,val
279,0510414_sc-150270.jpg,1,0,0,0,1,0,test
280,0510388_sc-156424.jpg,2,1,0,0,3,0,train
281,0510457_sc-209152.jpg,0,0,1,0,1,0,train
282,0510442_as-0001901.jpg,1,0,0,1,2,0,train
283,0510449_sc-1005082.jpg,5,1,2,0,8,0,train
284,0510420_as-0026101.jpg,3,0,0,2,5,0,train
285,0510461_as-0041411.jpg,1,0,0,0,1,0,val
286,0510387_sc-156424.jpg,1,0,1,1,3,0,test
287,0510444_as-7328681.jpg,0,1,1,0,2,0,train
288,0510450_sc-1005082.jpg,2,1,2,0,5,0,train
289,0510437_as-0006689.jpg,3,0,0,0,3,0,train
290,0510403_as-0006051.jpg,1,0,1,0,2,0,train
291,0510389_sc-156424.jpg,1,0,0,1,2,0,train
292,0510404_as-0006051.jpg,2,0,0,0,2,0,val
293,0510395_sc-1004931.jpg,0,0,1,1,2,0,test
294,0510419_as-0026101.jpg,1,0,1,0,2,0,train
295,0510382_as-0019006.jpg,1,0,0,0,1,0,train
296,0510463_sc-156205.jpg,1,0,0,0,1,0,train
297,0510411_sc-205872.jpg,3,2,1,0,6,0,train
298,0510429_as-0049645.jpg,2,0,0,1,3,0,train
299,0510398_sc-195957.jpg,6,0,1,1,8,0,val
300,0510436_as-0006689.jpg,1,0,0,1,2,0,test
301,0510448_as-2897650.jpg,1,0,0,0,1,0,train
302,0510456_sc-209152.jpg,1,0,0,1,2,0,train
303,0510384_as-0019006.jpg,2,0,0,0,2,0,train
304,0510452_sc-1005082.jpg,1,0,1,0,2,0,train
305,0510459_sc-209152.jpg,4,0,0,0,4,0,train
306,0510460_as-2623229.jpg,1,0,0,0,1,0,val
307,0510393_sc-1004931.jpg,1,0,0,0,1,0,test
308,0510400_sc-195957.jpg,3,2,0,0,5,0,train
309,0510446_as-9067729.jpg,1,0,0,0,1,0,train
310,0510415_sc-150270.jpg,3,0,1,1,5,0,train
311,0510465_sc-156205.jpg,3,0,1,1,5,0,train
312,0510472_as-0080056.jpg,3,2,0,0,5,0,train
313,0510506_sc-151954.jpg,2,0,0,0,2,0,val
314,0510477_sc-165943.jpg,1,0,0,0,1,0,test
315,0510494_sc-221105.jpg,1,0,0,0,1,0,train
316,0510499_sc-1017013.jpg,1,0,1,1,3,0,train
317,0510505_sc-151954.jpg,1,1,0,0,2,0,train
318,0510490_sc-221105.jpg,4,0,1,0,5,0,train
319,0510514_sc-1028898.jpg,2,1,2,0,5,0,train
320,0510495_sc-221105.jpg,2,0,0,0,2,0,val
321,0510511_as-0038905.jpg,5,3,0,0,8,0,test
322,0510481_sc-199232.jpg,1,0,0,0,1,0,train
323,0510497_sc-221105.jpg,2,0,1,0,3,0,train
324,0510515_sc-1028898.jpg,1,2,2,0,5,0,train
325,0510503_as-0055493.jpg,1,0,0,0,1,0,train
326,0510479_as-9096804.jpg,2,0,0,0,2,0,train
327,0510471_as-0080056.jpg,2,0,0,0,2,0,val
328,0510504_sc-151954.jpg,0,0,0,1,1,0,test
329,0510518_sc-1028898.jpg,3,0,0,1,4,0,train
330,0510513_as-0038905.jpg,1,0,0,0,1,0,train
331,0510485_sc-186553.jpg,3,0,1,0,4,0,train
332,0510474_as-0080056.jpg,5,0,1,1,7,0,train
333,0510491_sc-221105.jpg,0,1,0,0,1,0,train
334,0510470_as-0080056.jpg,3,0,1,0,4,0,val
335,0510473_as-0080056.jpg,1,0,0,0,1,0,test
336,0510508_as-2925829.jpg,1,0,0,0,1,0,train
337,0510483_sc-186553.jpg,1,0,3,1,5,0,train
338,0510466_as-7322572.jpg,1,0,0,0,1,0,train
339,0510484_sc-186553.jpg,4,2,0,0,6,0,train
340,0510469_sc-216054.jpg,1,0,0,0,1,0,train
341,0510468_sc-216054.jpg,4,0,1,0,5,0,val
342,0510500_sc-180055.jpg,1,0,1,1,3,0,test
343,0510496_sc-221105.jpg,1,2,0,0,3,0,train
344,0510516_sc-1028898.jpg,1,1,0,0,2,0,train
345,0510498_sc-1017013.jpg,2,0,0,1,3,0,train
346,0510502_as-0055493.jpg,9,0,0,0,9,0,train
347,0510480_sc-199232.jpg,0,1,0,0,1,0,train
348,0510507_sc-151954.jpg,1,0,0,0,1,0,val
349,0510510_as-0038905.jpg,2,0,0,0,2,0,test
350,0510512_as-0038905.jpg,3,0,0,0,3,0,train
351,0510489_as-2618232.jpg,3,1,0,1,5,0,train
352,0510486_sc-186553.jpg,3,0,1,0,4,0,train
353,0510519_sc-1028898.jpg,1,0,1,0,2,0,train
354,0510501_sc-180055.jpg,1,0,0,0,1,0,train
355,0510476_as-0080056.jpg,1,0,0,0,1,0,val
356,0510493_sc-221105.jpg,1,0,0,0,1,0,test
357,0510492_sc-221105.jpg,2,0,0,0,2,0,train
358,0510529_sc-187164.jpg,1,0,0,1,2,0,train
359,0510537_as-3325363.jpg,0,2,0,1,3,0,train
360,0510544_sc-1022312.jpg,1,0,0,0,1,0,train
361,0510531_as-0094917.jpg,4,1,0,0,5,0,train
362,0510543_sc-1020339.jpg,1,0,0,0,1,0,val
363,0510525_as-2809223.jpg,3,2,0,0,5,0,test
364,0510534_as-0094917.jpg,1,0,0,0,1,0,train
365,0510540_sc-104707.jpg,3,0,0,0,3,0,train
366,0510546_sc-1022312.jpg,3,0,0,0,3,0,train
367,0510559_sc-222421.jpg,1,0,0,0,1,0,train
368,0510552_as-0029819.jpg,4,1,0,0,5,0,train
369,0510557_as-7606057.jpg,0,1,1,0,2,0,val
370,0510536_as-0094917.jpg,1,0,1,1,3,0,test
371,0510554_sc-120647.jpg,0,1,0,0,1,0,train
372,0510545_sc-1022312.jpg,0,1,0,0,1,0,train
373,0510523_sc-126167.jpg,7,0,0,0,7,0,train
374,0510542_sc-1020339.jpg,0,0,1,0,1,0,train
375,0510533_as-0094917.jpg,2,0,0,0,2,0,train
376,0510553_sc-120647.jpg,1,0,1,0,2,0,val
377,0510556_sc-120647.jpg,0,0,3,0,3,0,test
378,0510526_sc-187164.jpg,4,0,1,0,5,0,train
379,0510528_sc-187164.jpg,1,0,0,0,1,0,train
380,0510541_sc-104707.jpg,2,0,0,0,2,0,train
381,0510555_sc-120647.jpg,1,0,1,0,2,0,train
382,0510560_sc-222421.jpg,6,2,3,2,13,0,train
383,0510548_as-7941818.jpg,1,0,0,0,1,0,val
384,0510558_sc-222421.jpg,1,1,1,0,3,0,test
385,0510532_as-0094917.jpg,1,0,0,0,1,0,train
386,0510524_sc-126167.jpg,1,1,0,0,2,0,train
387,0510561_as-3440053.jpg,1,0,0,1,2,0,train
388,0510562_sc-204377.jpg,1,1,0,0,2,0,train
389,0510592_sc-205812.jpg,2,0,0,0,2,0,train
390,0510572_as-0078603.jpg,2,0,2,1,5,0,val
391,0510610_sc-131237.jpg,2,0,0,0,2,0,test
392,0510596_sc-205812.jpg,1,0,0,0,1,0,train
393,0510586_sc-195444.jpg,1,0,1,0,2,0,train
394,0510584_sc-211889.jpg,1,2,1,0,4,0,train
395,0510600_as-0055123.jpg,2,1,1,0,4,0,train
396,0510588_sc-195444.jpg,0,0,1,2,3,0,train
397,0510568_as-0010501.jpg,1,0,0,2,3,0,val
398,0510594_sc-205812.jpg,3,0,0,0,3,0,test
399,0510609_sc-131237.jpg,2,0,0,0,2,0,train
400,0510593_sc-205812.jpg,3,1,2,0,6,0,train
401,0510605_as-0055123.jpg,1,0,0,0,1,0,train
402,0510611_sc-131237.jpg,2,2,1,0,5,0,train
403,0510567_as-0010501.jpg,0,1,0,0,1,0,train
404,0510617_sc-1026209.jpg,3,0,0,0,3,0,val
405,0510587_sc-195444.jpg,1,0,0,0,1,0,test
406,0510613_as-2513524.jpg,3,0,0,0,3,0,train
407,0510620_sc-1026209.jpg,1,0,1,0,2,0,train
408,0510615_sc-1026209.jpg,2,2,0,0,4,0,train
409,0510606_as-0055123.jpg,3,1,1,1,6,0,train
410,0510597_as-0055123.jpg,1,0,1,1,3,0,train
411,0510598_as-0055123.jpg,1,0,0,0,1,0,val
412,0510616_sc-1026209.jpg,2,0,2,0,4,0,test
413,0510566_as-0079293.jpg,1,0,0,1,2,0,train
414,0510569_as-0010501.jpg,1,0,0,0,1,0,train
415,0510603_as-0055123.jpg,1,0,0,1,2,0,train
416,0510618_sc-1026209.jpg,4,0,0,0,4,0,train
417,0510579_sc-211889.jpg,1,0,0,0,1,0,train
418,0510621_sc-1026209.jpg,1,0,1,0,2,0,val
419,0510599_as-0055123.jpg,4,0,0,1,5,0,test
420,0510570_as-0078603.jpg,1,0,0,0,1,0,train
421,0510581_sc-211889.jpg,2,0,0,0,2,0,train
422,0510608_sc-154984.jpg,0,0,0,1,1,0,train
423,0510591_sc-205812.jpg,2,0,2,0,4,0,train
424,0510601_as-0055123.jpg,1,0,0,0,1,0,train
425,0510577_sc-180355.jpg,1,0,1,1,3,0,val
426,0510573_as-0078603.jpg,1,1,0,0,2,0,test
427,0510580_sc-211889.jpg,3,0,0,0,3,0,train
428,0510614_sc-1026209.jpg,1,1,0,0,2,0,train
429,0510602_as-0055123.jpg,5,0,0,0,5,0,train
430,0510578_sc-211889.jpg,2,0,0,0,2,0,train
431,0510575_sc-180355.jpg,4,0,1,0,5,0,train
432,0510595_sc-205812.jpg,2,0,0,0,2,0,val
433,0510590_sc-195444.jpg,1,0,0,0,1,0,test
434,0510583_sc-211889.jpg,1,0,1,1,3,0,train
435,0510582_sc-211889.jpg,1,0,0,0,1,0,train
436,0510607_as-0055123.jpg,1,0,0,0,1,0,train
437,0510589_sc-195444.jpg,0,0,1,0,1,0,train
438,0510576_sc-180355.jpg,2,0,0,0,2,0,train
439,0510633_sc-154169.jpg,0,0,1,0,1,0,val
440,0510629_as-0013371.jpg,1,0,0,0,1,0,test
441,0510675_as-0059393.jpg,0,0,1,0,1,0,train
442,0510677_sc-171840.jpg,1,0,0,0,1,0,train
443,0510635_as-3308362.jpg,2,0,0,1,3,0,train
444,0510626_as-0013371.jpg,3,0,1,1,5,0,train
445,0510683_as-3108951.jpg,1,0,1,1,3,0,train
446,0510695_sc-224078.jpg,2,0,0,1,3,0,val
447,0510659_sc-1012669.jpg,2,1,0,0,3,0,test
448,0510693_sc-224078.jpg,2,0,0,0,2,0,train
449,0510672_as-0059393.jpg,2,2,1,1,6,0,train
450,0510685_sc-133717.jpg,2,2,0,0,4,0,train
451,0510680_sc-1002816.jpg,1,0,1,1,3,0,train
452,0510682_sc-1002816.jpg,1,0,0,0,1,0,train
453,0510639_as-0004665.jpg,3,2,1,0,6,0,val
454,0510664_sc-191327.jpg,3,1,2,1,7,0,test
455,0510628_as-0013371.jpg,2,0,0,0,2,0,train
456,0510670_as-7895418.jpg,2,0,1,0,3,0,train
457,0510627_as-0013371.jpg,5,2,1,1,9,0,train
458,0510637_sc-124490.jpg,1,0,0,0,1,0,train
459,0510694_sc-224078.jpg,2,0,0,0,2,0,train
460,0510642_as-0004665.jpg,2,0,0,0,2,0,val
461,0510668_sc-191327.jpg,2,1,1,0,4,0,test
462,0510662_as-0020149.jpg,1,1,0,0,2,0,train
463,0510661_as-0020149.jpg,0,0,0,1,1,0,train
464,0510653_as-0060224.jpg,0,0,1,0,1,0,train
465,0510669_as-2938367.jpg,5,0,1,0,6,0,train
466,0510690_sc-1013515.jpg,0,2,2,0,4,0,train
467,0510688_sc-1013515.jpg,4,0,1,0,5,0,val
468,0510654_as-9056099.jpg,2,0,0,0,2,0,test
469,0510652_as-0060224.jpg,1,1,0,1,3,0,train
470,0510655_as-0095552.jpg,1,1,0,0,2,0,train
471,0510624_as-0013371.jpg,4,1,1,1,7,0,train
472,0510644_sc-118110.jpg,1,0,0,0,1,0,train
473,0510656_sc-1012669.jpg,1,0,0,0,1,0,train
474,0510646_sc-118110.jpg,2,0,0,0,2,0,val
475,0510667_sc-191327.jpg,5,0,1,0,6,0,test
476,0510696_sc-224078.jpg,2,0,1,1,4,0,train
477,0510636_sc-124490.jpg,1,0,0,0,1,0,train
478,0510647_as-3329567.jpg,3,2,1,1,7,0,train
479,0510679_as-2582106.jpg,1,0,1,1,3,0,train
480,0510663_sc-191327.jpg,1,0,0,0,1,0,train
481,0510684_as-0079008.jpg,3,2,1,0,6,0,val
482,0510691_sc-224078.jpg,2,1,0,0,3,0,test
483,0510641_as-0004665.jpg,2,0,0,0,2,0,train
484,0510630_sc-154169.jpg,4,0,0,0,4,0,train
485,0510678_as-3453965.jpg,1,0,0,1,2,0,train
486,0510640_as-0004665.jpg,1,0,0,0,1,0,train
487,0510645_sc-118110.jpg,1,0,0,0,1,0,train
488,0510632_sc-154169.jpg,1,1,0,0,2,0,val
489,0510638_sc-124490.jpg,3,0,0,0,3,0,test
490,0510686_as-5373628.jpg,5,2,3,1,11,0,train
491,0510625_as-0013371.jpg,0,0,0,2,2,0,train
492,0510657_sc-1012669.jpg,6,0,0,0,6,0,train
493,0510658_sc-1012669.jpg,5,1,0,0,6,0,train
494,0510692_sc-224078.jpg,1,0,0,0,1,0,train
495,0510631_sc-154169.jpg,2,0,0,2,4,0,val
496,0510643_sc-118110.jpg,1,0,0,1,2,0,test
497,0510745_sc-1024977.jpg,2,1,0,0,3,0,train
498,0510729_as-0008149.jpg,3,0,0,0,3,0,train
499,0510711_as-0049068.jpg,24,1,1,0,26,0,train
500,0510726_as-0008149.jpg,1,0,0,1,2,0,train
501,0510718_as-3117175.jpg,0,1,0,0,1,0,train
502,0510746_sc-1024977.jpg,2,0,0,1,3,0,val
503,0510709_as-0017442.jpg,7,2,0,0,9,0,test
504,0510730_as-0008149.jpg,3,1,0,0,4,0,train
505,0510733_sc-1035641.jpg,0,0,2,1,3,0,train
506,0510750_sc-136271.jpg,2,1,1,0,4,0,train
507,0510754_as-0074365.jpg,3,0,0,0,3,0,train
508,0510724_as-0008149.jpg,4,2,1,0,7,0,train
509,0510756_as-0074365.jpg,1,0,0,0,1,0,val
510,0510702_sc-122481.jpg,2,0,0,0,2,0,test
511,0510705_as-7400404.jpg,1,0,0,0,1,0,train
512,0510714_as-0049068.jpg,2,0,1,0,3,0,train
513,0510753_as-0074365.jpg,1,1,1,0,3,0,train
514,0510744_sc-1024977.jpg,0,0,0,1,1,0,train
515,0510738_sc-189366.jpg,2,0,1,0,3,0,train
516,0510757_as-0074365.jpg,1,1,0,0,2,0,val
517,0510742_as-0009402.jpg,4,0,0,0,4,0,test
518,0510758_as-0074365.jpg,0,0,1,1,2,0,train
519,0510727_as-0008149.jpg,1,1,1,1,4,0,train
520,0510748_sc-136271.jpg,1,0,1,0,2,0,train
521,0510701_sc-122481.jpg,0,0,1,0,1,0,train
522,0510712_as-0049068.jpg,1,0,1,1,3,0,train
523,0510698_sc-198010.jpg,4,1,0,0,5,0,val
524,0510700_sc-122481.jpg,1,0,0,0,1,0,test
525,0510708_as-9067183.jpg,4,0,0,0,4,0,train
526,0510721_as-0081465.jpg,1,0,0,1,2,0,train
527,0510713_as-0049068.jpg,0,0,3,0,3,0,train
528,0510725_as-0008149.jpg,1,0,0,0,1,0,train
529,0510739_as-7885760.jpg,3,0,1,0,4,0,train
530,0510710_as-0049068.jpg,7,0,0,0,7,0,val
531,0510734_sc-1035641.jpg,1,0,0,1,2,0,test
532,0510747_sc-136271.jpg,3,0,1,4,8,0,train
533,0510728_as-0008149.jpg,1,0,1,1,3,0,train
534,0510749_sc-136271.jpg,1,0,0,1,2,0,train
535,0510737_as-7043235.jpg,1,1,1,2,5,0,train
536,0510755_as-0074365.jpg,2,0,2,0,4,0,train
537,0510731_as-2991733.jpg,1,0,1,1,3,0,val
538,0510697_as-3322100.jpg,1,1,0,0,2,0,test
539,0510752_as-0074365.jpg,0,0,1,0,1,0,train
540,0510741_as-0009402.jpg,0,1,0,0,1,0,train
541,0510722_as-0081465.jpg,4,1,1,1,7,0,train
542,0510717_sc-172496.jpg,1,0,1,0,2,0,train
543,0510715_as-0049068.jpg,3,2,0,0,5,0,train
544,0510800_as-0057076.jpg,3,0,0,0,3,0,val
545,0510823_as-0024464.jpg,2,0,0,0,2,0,test
546,0510783_sc-186373.jpg,1,0,0,0,1,0,train
547,0510815_as-0088910.jpg,1,0,0,0,1,0,train
548,0510771_as-2619008.jpg,0,2,1,0,3,0,train
549,0510796_as-0057076.jpg,1,0,0,0,1,0,train
550,0510762_as-0095501.jpg,1,1,0,0,2,0,train
551,0510827_as-0029759.jpg,0,0,1,0,1,0,val
552,0510761_as-3070949.jpg,1,0,0,1,2,0,test
553,0510829_sc-214765.jpg,1,0,0,0,1,0,train
554,0510802_as-0057076.jpg,1,1,1,1,4,0,train
555,0510768_sc-1003164.jpg,1,0,0,0,1,0,train
556,0510766_sc-219853.jpg,2,0,1,0,3,0,train
557,0510806_as-3069035.jpg,1,0,2,0,3,0,train
558,0510775_as-0066454.jpg,2,0,0,0,2,0,val
559,0510788_as-2639814.jpg,2,0,1,0,3,0,test
560,0510804_sc-211087.jpg,1,2,1,0,4,0,train
561,0510819_as-0085192.jpg,2,0,1,0,3,0,train
562,0510785_sc-186373.jpg,0,0,2,2,4,0,train
563,0510826_as-0029759.jpg,0,0,2,1,3,0,train
564,0510777_as-0065608.jpg,0,0,3,0,3,0,train
565,0510817_as-0085192.jpg,2,0,0,0,2,0,val
566,0510803_sc-211087.jpg,0,1,0,0,1,0,test
567,0510781_as-0065608.jpg,1,1,1,1,4,0,train
568,0510780_as-0065608.jpg,1,0,0,1,2,0,train
569,0510773_as-0030794.jpg,2,1,1,0,4,0,train
570,0510799_as-0057076.jpg,2,0,0,0,2,0,train
571,0510797_as-0057076.jpg,3,0,0,1,4,0,train
572,0510786_sc-186373.jpg,1,0,0,0,1,0,val
573,0510791_as-3237466.jpg,2,0,0,0,2,0,test
574,0510789_as-2900621.jpg,3,1,0,0,4,0,train
575,0510813_as-0088910.jpg,6,0,0,0,6,0,train
576,0510814_as-0088910.jpg,3,1,1,1,6,0,train
577,0510818_as-0085192.jpg,2,0,0,0,2,0,train
578,0510760_sc-105935.jpg,3,0,0,1,4,0,train
579,0510790_as-2626962.jpg,4,0,0,0,4,0,val
580,0510763_as-0095501.jpg,3,1,2,0,6,0,test
581,0510767_sc-219853.jpg,1,0,0,0,1,0,train
582,0510774_as-0030794.jpg,1,0,0,1,2,0,train
583,0510795_as-3251191.jpg,1,0,0,0,1,0,train
584,0510765_as-7119879.jpg,0,0,2,0,2,0,train
585,0510805_sc-211087.jpg,2,0,0,0,2,0,train
586,0510776_as-0066454.jpg,1,0,0,1,2,0,val
587,0510784_sc-186373.jpg,0,2,0,0,2,0,test
588,0510793_as-0075542.jpg,1,1,1,0,3,0,train
589,0510770_sc-1003164.jpg,1,0,0,0,1,0,train
590,0510779_as-0065608.jpg,1,1,0,0,2,0,train
591,0510787_sc-186373.jpg,1,0,0,0,1,0,train
592,0510825_as-0029759.jpg,1,0,0,0,1,0,train
593,0510809_as-0088910.jpg,0,0,1,0,1,0,val
594,0510810_as-0088910.jpg,1,0,0,0,1,0,test
595,0510824_as-0027914.jpg,0,1,1,0,2,0,train
596,0510798_as-0057076.jpg,0,0,1,1,2,0,train
597,0510801_as-0057076.jpg,3,0,0,0,3,0,train
598,0510794_sc-212220.jpg,0,0,0,1,1,0,train
599,0510778_as-0065608.jpg,1,0,0,0,1,0,train
600,0510866_as-0070196.jpg,3,0,0,0,3,0,val
601,0510846_as-0082585.jpg,0,0,2,0,2,0,test
602,0510862_as-0070196.jpg,1,0,0,0,1,0,train
603,0510841_as-7323839.jpg,1,0,0,1,2,0,train
604,0510867_sc-214047.jpg,1,0,0,0,1,0,train
605,0510845_as-0082585.jpg,1,0,0,0,1,0,train
606,0510854_as-0014293.jpg,1,0,0,0,1,0,train
607,0510865_as-0070196.jpg,2,1,0,0,3,0,val
608,0510848_as-0082585.jpg,3,0,1,0,4,0,test
609,0510860_as-0014293.jpg,1,0,0,0,1,0,train
610,0510864_as-0070196.jpg,4,0,0,0,4,0,train
611,0510840_sc-143406.jpg,1,1,0,1,3,0,train
612,0510858_as-0014293.jpg,1,0,0,1,2,0,train
613,0510852_as-0082585.jpg,2,0,2,1,5,0,train
614,0510834_as-0027668.jpg,3,1,2,0,6,0,val
615,0510857_as-0014293.jpg,2,0,0,1,3,0,test
616,0510851_as-0082585.jpg,6,2,3,1,12,0,train
617,0510856_as-0014293.jpg,1,0,2,1,4,0,train
618,0510835_as-0027668.jpg,4,3,1,0,8,0,train
619,0510853_as-3401671.jpg,0,0,1,1,2,0,train
620,0510859_as-0014293.jpg,3,0,0,1,4,0,train
621,0510868_sc-103579.jpg,1,0,0,0,1,0,val
622,0510850_as-0082585.jpg,1,1,0,0,2,0,test
623,0510869_as-2526484.jpg,2,1,1,0,4,0,train
624,0510863_as-0070196.jpg,1,0,0,0,1,0,train
625,0510833_as-0027668.jpg,0,0,0,1,1,0,train
626,0510837_sc-1023572.jpg,3,0,0,0,3,0,train
627,0510855_as-0014293.jpg,3,0,0,0,3,0,train
628,0510838_sc-1023572.jpg,1,0,0,0,1,0,val
629,0510849_as-0082585.jpg,1,0,0,0,1,0,test
630,0510836_sc-1023572.jpg,2,0,0,1,3,0,train
631,0510896_as-0061522.jpg,2,0,0,0,2,0,train
632,0510880_sc-119241.jpg,3,0,0,0,3,0,train
633,0510892_as-0061522.jpg,1,0,1,0,2,0,train
634,0510906_sc-137831.jpg,2,2,2,1,7,0,train
635,0510888_as-0061522.jpg,1,0,0,0,1,0,val
636,0510901_as-0070887.jpg,3,0,0,1,4,0,test
637,0510891_as-0061522.jpg,4,1,2,0,7,0,train
638,0510889_as-0061522.jpg,1,0,1,0,2,0,train
639,0510883_as-3046088.jpg,1,0,1,1,3,0,train
640,0510886_sc-173177.jpg,2,1,0,0,3,0,train
641,0510898_as-0061522.jpg,0,2,0,0,2,0,train
642,0510882_sc-119241.jpg,1,0,0,1,2,0,val
643,0510890_as-0061522.jpg,1,0,1,0,2,0,test
644,0510905_as-0070887.jpg,1,0,0,0,1,0,train
645,0510884_as-2804714.jpg,1,0,0,0,1,0,train
646,0510875_sc-128038.jpg,0,1,1,0,2,0,train
647,0510874_sc-128038.jpg,1,0,0,0,1,0,train
648,0510895_as-0061522.jpg,1,0,1,2,4,0,train
649,0510902_as-0070887.jpg,0,1,0,0,1,0,val
650,0510877_as-0071330.jpg,2,0,0,0,2,0,test
651,0510887_as-0061522.jpg,3,1,1,0,5,0,train
652,0510885_sc-173177.jpg,3,0,0,0,3,0,train
653,0510876_sc-128038.jpg,0,2,0,0,2,0,train
654,0510904_as-0070887.jpg,2,0,0,0,2,0,train
655,0510870_as-2526484.jpg,1,1,1,0,3,0,train
656,0510878_as-7695866.jpg,1,0,0,0,1,0,val
657,0510893_as-0061522.jpg,2,1,0,0,3,0,test
658,0510900_as-0068421.jpg,1,0,0,0,1,0,train
659,0510894_as-0061522.jpg,9,0,0,0,9,0,train
660,0510897_as-0061522.jpg,1,0,0,0,1,0,train
661,0510903_as-0070887.jpg,1,0,0,1,2,0,train
662,0510879_as-2509263.jpg,6,1,0,0,7,0,train
663,0510881_sc-119241.jpg,0,0,0,1,1,0,val
664,0510919_as-0027561.jpg,0,1,0,1,2,0,test
665,0510947_sc-1009106.jpg,3,0,0,2,5,0,train
666,0510954_as-0055935.jpg,3,1,1,0,5,0,train
667,0510935_sc-198030.jpg,2,0,0,0,2,0,train
668,0510965_as-0086756.jpg,4,0,0,1,5,0,train
669,0510910_as-3348845.jpg,5,2,1,0,8,0,train
670,0510934_sc-198030.jpg,1,0,0,0,1,0,val
671,0510963_as-0082485.jpg,0,0,0,1,1,0,test
672,0510914_sc-1017112.jpg,4,0,0,0,4,0,train
673,0510948_sc-1009106.jpg,2,0,1,1,4,0,train
674,0510939_as-2772838.jpg,2,0,0,0,2,0,train
675,0510924_as-0057469.jpg,1,0,1,1,3,0,train
676,0510941_as-9080379.jpg,1,0,0,0,1,0,train
677,0510916_sc-211761.jpg,1,1,2,0,4,0,val
678,0510929_sc-219204.jpg,2,0,1,0,3,0,test
679,0510956_as-0055935.jpg,1,0,0,1,2,0,train
680,0510949_sc-1009106.jpg,0,1,1,0,2,0,train
681,0510962_as-7809769.jpg,3,0,0,0,3,0,train
682,0510923_sc-1003141.jpg,0,0,2,0,2,0,train
683,0510951_sc-1009106.jpg,3,0,2,0,5,0,train
684,0510925_as-0057469.jpg,3,0,0,1,4,0,val
685,0510966_as-0086756.jpg,2,0,0,1,3,0,test
686,0510932_as-3471137.jpg,1,0,2,0,3,0,train
687,0510931_as-2982800.jpg,1,0,1,1,3,0,train
688,0510952_sc-1009106.jpg,4,1,1,0,6,0,train
689,0510944_sc-1009106.jpg,1,0,0,0,1,0,train
690,0510922_as-0027561.jpg,1,0,0,0,1,0,train
691,0510964_as-0082485.jpg,26,0,1,0,27,0,val
692,0510967_as-3279115.jpg,1,0,0,0,1,0,test
693,0510955_as-0055935.jpg,3,1,2,1,7,0,train
694,0510959_as-7973383.jpg,1,0,1,1,3,0,train
695,0510921_as-0027561.jpg,1,1,0,0,2,0,train
696,0510940_sc-166553.jpg,9,1,0,1,11,0,train
697,0510908_sc-159577.jpg,1,0,0,0,1,0,train
698,0510927_sc-219204.jpg,1,0,0,1,2,0,val
699,0510933_sc-198030.jpg,1,1,0,0,2,0,test
700,0510920_as-0027561.jpg,3,1,3,2,9,0,train
701,0510958_as-0055935.jpg,1,0,0,0,1,0,train
702,0510945_sc-1009106.jpg,1,0,0,0,1,0,train
703,0510912_sc-1017112.jpg,0,1,0,0,1,0,train
704,0510960_as-3089395.jpg,1,0,0,0,1,0,train
705,0510943_sc-134473.jpg,1,0,0,0,1,0,val
706,0510915_sc-1017112.jpg,6,1,1,1,9,0,test
707,0510926_sc-219204.jpg,1,0,2,1,4,0,train
708,0510938_as-3075767.jpg,2,0,0,0,2,0,train
709,0510957_as-0055935.jpg,1,0,1,0,2,0,train
710,0510913_sc-1017112.jpg,1,0,0,0,1,0,train
711,0510936_sc-198030.jpg,1,0,0,0,1,0,train
712,0510950_sc-1009106.jpg,3,0,0,2,5,0,val
713,0510946_sc-1009106.jpg,5,1,0,0,6,0,test
714,0510930_as-3030691.jpg,1,0,0,0,1,0,train
715,0510928_sc-219204.jpg,1,0,1,0,2,0,train
716,0511026_as-0047050.jpg,4,1,2,1,8,0,train
717,0510973_as-0028077.jpg,1,0,0,0,1,0,train
718,0510988_as-0082401.jpg,1,1,0,0,2,0,train
719,0510994_sc-211356.jpg,1,0,1,1,3,0,val
720,0510987_as-0082401.jpg,3,0,0,1,4,0,test
721,0510981_as-7285632.jpg,1,0,0,0,1,0,train
722,0510992_as-0082401.jpg,4,0,0,0,4,0,train
723,0511033_as-0100102.jpg,2,0,2,0,4,0,train
724,0510983_sc-1038632.jpg,2,0,0,1,3,0,train
725,0511036_as-0014064.jpg,0,0,1,0,1,0,train
726,0510976_as-0028077.jpg,1,0,0,0,1,0,val
727,0511052_sc-1032546.jpg,2,0,0,0,2,0,test
728,0511020_sc-1015832.jpg,1,0,0,0,1,0,train
729,0511010_sc-192085.jpg,1,1,1,0,3,0,train
730,0510998_as-0036525.jpg,1,0,0,0,1,0,train
731,0511004_sc-112676.jpg,2,0,0,0,2,0,train
732,0510975_as-0028077.jpg,1,0,0,0,1,0,train
733,0511049_sc-1032546.jpg,0,1,0,1,2,0,val
734,0510989_as-0082401.jpg,1,0,0,1,2,0,test
735,0511038_as-0014064.jpg,3,0,1,0,4,0,train
736,0511005_sc-112676.jpg,1,0,0,0,1,0,train
737,0510982_sc-1038632.jpg,3,0,1,0,4,0,train
738,0511054_sc-1032546.jpg,1,0,0,0,1,0,train
739,0511035_as-0014064.jpg,0,0,1,0,1,0,train
740,0511006_as-7518274.jpg,3,0,0,0,3,0,val
741,0511017_sc-222969.jpg,1,1,1,0,3,0,test
742,0510971_as-0028077.jpg,0,0,2,1,3,0,train
743,0511048_sc-1032546.jpg,1,0,0,1,2,0,train
744,0510999_as-0036525.jpg,2,0,0,0,2,0,train
745,0511028_as-0047050.jpg,5,0,0,0,5,0,train
746,0511009_sc-192085.jpg,5,0,0,0,5,0,train
747,0511015_sc-107791.jpg,0,0,0,1,1,0,val
748,0511032_as-0100102.jpg,1,0,0,0,1,0,test
749,0511037_as-0014064.jpg,14,2,1,0,17,0,train
750,0511043_sc-1006170.jpg,1,0,0,0,1,0,train
751,0511025_as-0047050.jpg,1,0,0,1,2,0,train
752,0511000_as-0036525.jpg,2,0,0,0,2,0,train
753,0510997_sc-153564.jpg,0,1,0,0,1,0,train
754,0511007_sc-192085.jpg,1,0,1,0,2,0,val
755,0510970_as-0028077.jpg,0,0,2,0,2,0,test
756,0511001_as-0036525.jpg,1,0,3,2,6,0,train
757,0511030_as-0047050.jpg,13,0,0,0,13,0,train
758,0510972_as-0028077.jpg,1,0,1,0,2,0,train
759,0511011_sc-192085.jpg,2,0,3,0,5,0,train
760,0511044_as-3302073.jpg,2,1,0,0,3,0,train
761,0511013_sc-107791.jpg,1,1,1,1,4,0,val
762,0510996_sc-153564.jpg,0,0,1,1,2,0,test
763,0511014_sc-107791.jpg,1,0,0,0,1,0,train
764,0511027_as-0047050.jpg,0,0,1,0,1,0,train
765,0511024_as-3191395.jpg,0,0,1,0,1,0,train
766,0511047_sc-1032546.jpg,1,0,0,0,1,0,train
767,0511031_as-0100102.jpg,1,0,0,0,1,0,train
768,0511012_as-2562395.jpg,1,0,0,0,1,0,val
769,0511046_sc-1032546.jpg,1,0,0,0,1,0,test
770,0511021_sc-1015832.jpg,2,0,0,0,2,0,train
771,0511022_sc-130997.jpg,0,1,0,0,1,0,train
772,0510990_as-0082401.jpg,3,1,2,0,6,0,train
773,0511029_as-0047050.jpg,7,0,0,1,8,0,train
774,0511045_sc-1032546.jpg,3,0,0,0,3,0,train
775,0510995_sc-153564.jpg,1,0,1,1,3,0,val
776,0511008_sc-192085.jpg,2,0,0,0,2,0,test
777,0511053_sc-1032546.jpg,2,0,0,1,3,0,train
778,0511023_as-7281634.jpg,2,0,0,0,2,0,train
779,0511050_sc-1032546.jpg,3,1,2,0,6,0,train
780,0511079_as-0090438.jpg,0,0,0,1,1,0,train
781,0511082_as-0097146.jpg,3,0,1,0,4,0,train
782,0511101_as-0065098.jpg,0,1,0,0,1,0,val
783,0511099_as-0065098.jpg,1,0,0,0,1,0,test
784,0511078_sc-135406.jpg,2,1,1,1,5,0,train
785,0511062_as-0050950.jpg,3,0,0,0,3,0,train
786,0511092_sc-209279.jpg,1,0,0,0,1,0,train
787,0511072_sc-196012.jpg,5,0,0,1,6,0,train
788,0511085_as-0043361.jpg,1,0,0,0,1,0,train
789,0511089_sc-194644.jpg,2,0,0,0,2,0,val
790,0511076_sc-196012.jpg,0,1,1,0,2,0,test
791,0511056_sc-1027338.jpg,0,0,2,1,3,0,train
792,0511067_sc-135556.jpg,1,0,0,0,1,0,train
793,0511073_sc-196012.jpg,2,0,0,0,2,0,train
794,0511066_sc-135556.jpg,1,0,0,0,1,0,train
795,0511090_sc-194644.jpg,3,0,0,0,3,0,train
796,0511060_as-0050950.jpg,0,0,0,1,1,0,val
797,0511074_sc-196012.jpg,3,2,2,0,7,0,test
798,0511102_as-0065098.jpg,1,0,0,0,1,0,train
799,0511097_as-0065098.jpg,2,0,0,0,2,0,train
800,0511075_sc-196012.jpg,9,0,1,0,10,0,train
801,0511077_sc-135406.jpg,0,0,1,0,1,0,train
802,0511080_as-0090438.jpg,1,0,0,0,1,0,train
803,0511069_sc-135556.jpg,5,0,1,1,7,0,val
804,0511068_sc-135556.jpg,1,0,0,0,1,0,test
805,0511057_sc-1027338.jpg,1,1,0,0,2,0,train
806,0511091_sc-194644.jpg,0,2,2,0,4,0,train
807,0511083_as-0097146.jpg,0,0,1,0,1,0,train
808,0511061_as-0050950.jpg,7,0,0,0,7,0,train
809,0511063_as-0050950.jpg,2,0,1,2,5,0,train
810,0511081_as-9058629.jpg,3,0,1,0,4,0,val
811,0511070_as-7658400.jpg,2,0,0,0,2,0,test
812,0511100_as-0065098.jpg,1,0,0,1,2,0,train
813,0511064_as-2595009.jpg,2,1,1,0,4,0,train
814,0511095_as-0065098.jpg,1,1,0,0,2,0,train
815,0511071_sc-196012.jpg,2,0,1,1,4,0,train
816,0511098_as-0065098.jpg,1,0,0,0,1,0,train
817,0511096_as-0065098.jpg,0,0,1,0,1,0,val
818,0511055_sc-1027338.jpg,0,1,0,0,1,0,test
819,0511093_sc-209279.jpg,6,0,0,0,6,0,train
820,0511112_sc-113765.jpg,5,0,1,0,6,0,train
821,0511107_as-0072540.jpg,1,1,0,0,2,0,train
822,0511106_as-0072540.jpg,0,0,1,2,3,0,train
823,0511110_sc-113765.jpg,1,0,0,0,1,0,train
824,0511111_sc-113765.jpg,5,1,1,1,8,0,val
825,0511109_sc-113765.jpg,1,1,0,0,2,0,test
826,0511105_as-0072540.jpg,1,0,2,0,3,0,train
827,0511108_sc-113765.jpg,1,0,0,0,1,0,train
828,0511114_as-2738069.jpg,3,0,0,0,3,0,train
829,0511137_as-3398721.jpg,1,0,0,0,1,0,train
830,0511147_as-0004002.jpg,1,0,0,0,1,0,train
831,0511156_as-3424853.jpg,2,0,1,0,3,0,val
832,0511146_as-0004002.jpg,1,0,0,2,3,0,test
833,0511139_as-3202182.jpg,6,0,2,0,8,0,train
834,0511162_sc-1017125.jpg,1,1,0,0,2,0,train
835,0511144_sc-119865.jpg,2,2,1,0,5,0,train
836,0511124_sc-1023271.jpg,5,0,0,0,5,0,train
837,0511119_sc-215383.jpg,1,0,1,0,2,0,train
838,0511130_sc-224741.jpg,4,0,1,1,6,0,val
839,0511145_as-7316055.jpg,1,0,1,1,3,0,test
840,0511133_sc-126518.jpg,2,3,0,0,5,0,train
841,0511131_sc-224741.jpg,2,0,1,1,4,0,train
842,0511118_sc-215383.jpg,1,0,0,0,1,0,train
843,0511115_sc-214452.jpg,2,0,0,0,2,0,train
844,0511165_sc-1017125.jpg,1,0,2,0,3,0,train
845,0511122_sc-1016950.jpg,2,0,0,0,2,0,val
846,0511136_sc-125950.jpg,1,0,1,0,2,0,test
847,0511151_sc-198696.jpg,0,0,1,1,2,0,train
848,0511121_sc-1016950.jpg,0,0,1,1,2,0,train
849,0511153_sc-198696.jpg,1,0,0,0,1,0,train
850,0511157_sc-116621.jpg,3,0,0,0,3,0,train
851,0511120_sc-1016950.jpg,4,0,1,0,5,0,train
852,0511129_sc-224741.jpg,1,0,0,0,1,0,val
853,0511155_as-0005117.jpg,1,0,2,0,3,0,test
854,0511149_as-0004002.jpg,1,1,0,1,3,0,train
855,0511148_as-0004002.jpg,1,0,0,0,1,0,train
856,0511123_sc-1023271.jpg,1,3,4,2,10,0,train
857,0511159_sc-200143.jpg,1,0,0,1,2,0,train
858,0511132_sc-126518.jpg,7,0,0,0,7,0,train
859,0511116_sc-214452.jpg,1,1,0,0,2,0,val
860,0511154_as-0014012.jpg,2,2,1,1,6,0,test
861,0511158_sc-200143.jpg,2,0,0,0,2,0,train
862,0511166_sc-1017125.jpg,1,0,0,0,1,0,train
863,0511142_sc-119865.jpg,6,1,1,2,10,0,train
864,0511138_as-0075131.jpg,1,0,0,0,1,0,train
865,0511140_as-0076667.jpg,3,0,0,2,5,0,train
866,0511127_as-2600661.jpg,1,0,0,0,1,0,val
867,0511117_as-3448458.jpg,2,0,1,0,3,0,test
868,0511143_sc-119865.jpg,1,0,0,1,2,0,train
869,0511134_sc-126518.jpg,4,0,0,2,6,0,train
870,0511167_sc-1017125.jpg,2,0,1,1,4,0,train
871,0511161_sc-221163.jpg,3,0,0,0,3,0,train
872,0511135_sc-126518.jpg,2,1,0,1,4,0,train
873,0511126_as-2890457.jpg,0,1,0,0,1,0,val
874,0511141_as-0076667.jpg,1,0,0,0,1,0,test
875,0511169_sc-192464.jpg,0,0,1,0,1,0,train
876,0511184_as-3296591.jpg,1,0,0,0,1,0,train
877,0511237_as-0046406.jpg,1,0,1,0,2,0,train
878,0511189_sc-217381.jpg,1,0,1,0,2,0,train
879,0511240_as-0046406.jpg,3,0,0,1,4,0,train
880,0511202_sc-155638.jpg,2,1,2,0,5,0,val
881,0511211_as-0082638.jpg,4,0,1,0,5,0,test
882,0511218_as-0082638.jpg,1,0,0,1,2,0,train
883,0511233_sc-214570.jpg,2,0,0,2,4,0,train
884,0511234_sc-214570.jpg,2,0,0,0,2,0,train
885,0511180_as-0077733.jpg,8,1,1,1,11,0,train
886,0511187_sc-203492.jpg,1,1,1,0,3,0,train
887,0511241_as-0046406.jpg,0,0,0,4,4,0,val
888,0511215_as-0082638.jpg,1,0,0,0,1,0,test
889,0511170_sc-192464.jpg,0,1,0,0,1,0,train
890,0511171_sc-192464.jpg,3,1,0,0,4,0,train
891,0511196_sc-211880.jpg,3,0,0,0,3,0,train
892,0511173_sc-192464.jpg,1,0,0,0,1,0,train
893,0511192_sc-217381.jpg,5,0,0,0,5,0,train
894,0511226_sc-136821.jpg,3,0,0,1,4,0,val
895,0511168_sc-192464.jpg,7,0,0,1,8,0,test
896,0511190_sc-217381.jpg,2,1,0,0,3,0,train
897,0511239_as-0046406.jpg,1,1,0,0,2,0,train
898,0511191_sc-217381.jpg,0,0,0,1,1,0,train
899,0511242_as-0046406.jpg,2,0,0,0,2,0,train
900,0511208_as-0054290.jpg,1,0,0,1,2,0,train
901,0511232_sc-214570.jpg,1,0,0,0,1,0,val
902,0511236_as-3315463.jpg,1,0,0,0,1,0,test
903,0511177_as-0051716.jpg,1,0,1,0,2,0,train
904,0511235_as-3272864.jpg,1,0,0,0,1,0,train
905,0511245_as-0080078.jpg,1,0,0,0,1,0,train
906,0511207_as-0054290.jpg,5,2,1,0,8,0,train
907,0511238_as-0046406.jpg,2,0,1,1,4,0,train
908,0511194_as-2730978.jpg,14,3,1,0,18,0,val
909,0511219_as-7381374.jpg,4,0,0,0,4,0,test
910,0511230_sc-214570.jpg,1,0,1,0,2,0,train
911,0511212_as-0082638.jpg,1,1,0,0,2,0,train
912,0511227_as-2996837.jpg,0,0,1,1,2,0,train
913,0511224_sc-136821.jpg,3,1,1,0,5,0,train
914,0511193_sc-217381.jpg,4,0,0,0,4,0,train
915,0511228_sc-214570.jpg,2,0,0,0,2,0,val
916,0511210_as-0082638.jpg,4,0,0,0,4,0,test
917,0511214_as-0082638.jpg,8,0,2,0,10,0,train
918,0511195_as-2879290.jpg,1,0,0,1,2,0,train
919,0511179_as-0077733.jpg,4,0,2,0,6,0,train
920,0511205_as-0054290.jpg,1,0,0,0,1,0,train
921,0511201_sc-155638.jpg,2,0,0,0,2,0,train
922,0511172_sc-192464.jpg,2,0,0,2,4,0,val
923,0511223_sc-182237.jpg,2,0,0,0,2,0,test
924,0511213_as-0082638.jpg,0,1,0,0,1,0,train
925,0511209_as-0082638.jpg,3,0,0,0,3,0,train
926,0511246_as-0080078.jpg,0,0,1,0,1,0,train
927,0511217_as-0082638.jpg,3,1,0,0,4,0,train
928,0511231_sc-214570.jpg,2,3,3,2,10,0,train
929,0511182_as-0077733.jpg,1,0,0,0,1,0,val
930,0511206_as-0054290.jpg,2,0,0,0,2,0,test
931,0511183_as-0077733.jpg,2,0,0,0,2,0,train
932,0511229_sc-214570.jpg,3,0,0,0,3,0,train
933,0511174_sc-192464.jpg,1,0,0,1,2,0,train
934,0511188_sc-203492.jpg,1,1,0,0,2,0,train
935,0511186_sc-203492.jpg,1,0,0,0,1,0,train
936,0511220_as-2688921.jpg,3,1,1,0,5,0,val
937,0511216_as-0082638.jpg,2,0,1,0,3,0,test
938,0511175_sc-192464.jpg,1,0,1,1,3,0,train
939,0511225_sc-136821.jpg,1,0,1,0,2,0,train
940,0511298_as-0071482.jpg,6,0,1,0,7,0,train
941,0511265_sc-114923.jpg,1,0,0,0,1,0,train
942,0511266_as-2967126.jpg,0,0,0,1,1,0,train
943,0511276_as-0087672.jpg,8,1,0,0,9,0,val
944,0511293_sc-142089.jpg,1,0,1,0,2,0,test
945,0511271_sc-172716.jpg,1,0,0,0,1,0,train
946,0511270_sc-154971.jpg,1,0,1,0,2,0,train
947,0511296_sc-142089.jpg,1,0,0,0,1,0,train
948,0511308_as-9049081.jpg,1,0,0,0,1,0,train
949,0511305_sc-204311.jpg,0,0,0,1,1,0,train
950,0511258_sc-1020653.jpg,0,0,1,0,1,0,val
951,0511279_sc-126958.jpg,0,1,0,0,1,0,test
952,0511299_as-0071482.jpg,0,0,1,0,1,0,train
953,0511267_as-2761276.jpg,3,1,1,0,5,0,train
954,0511289_sc-226642.jpg,3,0,0,1,4,0,train
955,0511282_sc-146127.jpg,1,0,0,0,1,0,train
956,0511297_as-0071482.jpg,1,0,0,0,1,0,train
957,0511301_sc-187075.jpg,9,0,0,0,9,0,val
958,0511287_sc-1032134.jpg,2,0,1,0,3,0,test
959,0511252_sc-112625.jpg,3,0,0,0,3,0,train
960,0511309_as-0003618.jpg,0,0,1,1,2,0,train
961,0511253_sc-112625.jpg,1,0,0,0,1,0,train
962,0511268_sc-154971.jpg,3,0,0,0,3,0,train
963,0511269_sc-154971.jpg,3,0,1,0,4,0,train
964,0511256_sc-112625.jpg,1,0,0,0,1,0,val
965,0511248_as-0054460.jpg,5,0,0,0,5,0,test
966,0511274_as-0087672.jpg,1,0,0,1,2,0,train
967,0511259_as-3206944.jpg,1,0,0,0,1,0,train
968,0511288_sc-1032134.jpg,2,1,0,0,3,0,train
969,0511273_sc-172716.jpg,0,0,1,0,1,0,train
970,0511278_as-7998033.jpg,1,0,0,1,2,0,train
971,0511262_as-0082452.jpg,1,0,0,0,1,0,val
972,0511254_sc-112625.jpg,4,0,1,1,6,0,test
973,0511249_as-0054460.jpg,1,1,0,0,2,0,train
974,0511285_sc-1032134.jpg,2,1,0,0,3,0,train
975,0511294_sc-142089.jpg,2,0,0,0,2,0,train
976,0511280_sc-146127.jpg,1,0,0,0,1,0,train
977,0511290_sc-142089.jpg,4,1,3,1,9,0,train
978,0511304_sc-187075.jpg,0,0,1,0,1,0,val
979,0511292_sc-142089.jpg,2,0,0,0,2,0,test
980,0511286_sc-1032134.jpg,1,1,0,0,2,0,train
981,0511302_sc-187075.jpg,1,0,0,0,1,0,train
982,0511300_sc-187075.jpg,1,0,0,1,2,0,train
983,0511291_sc-142089.jpg,0,0,1,0,1,0,train
984,0511275_as-0087672.jpg,1,0,0,0,1,0,train
985,0511281_sc-146127.jpg,0,0,1,0,1,0,val
986,0511264_as-0082452.jpg,0,1,0,0,1,0,test
987,0511283_as-3126696.jpg,1,0,0,0,1,0,train
988,0511250_as-0054460.jpg,1,1,0,0,2,0,train
989,0511306_sc-204311.jpg,0,1,0,0,1,0,train
990,0511272_sc-172716.jpg,2,0,1,0,3,0,train
991,0511255_sc-112625.jpg,2,0,0,0,2,0,train
992,0511303_sc-187075.jpg,1,0,0,1,2,0,val
993,0509908_as-0085701.jpg,3,0,0,0,3,0,test
994,0511199_sc-155638.jpg,0,0,0,1,1,0,train
995,0509462_as-0082108.jpg,2,1,1,1,5,0,train
996,0508841_sc-174250.jpg,3,0,2,0,5,0,train
997,0509334_sc-195846.jpg,1,0,0,0,1,0,train
998,0509727_sc-163991.jpg,2,0,1,0,3,0,train
999,0509461_as-0082108.jpg,1,0,0,0,1,0,val
1000,0508810_sc-124828.jpg,0,0,1,0,1,0,test
1001,0508830_sc-149002.jpg,1,0,2,0,3,0,train
1002,0508844_sc-174250.jpg,3,0,0,1,4,0,train
1003,0508800_as-0036134.jpg,0,0,1,0,1,0,train
1004,0508818_sc-201826.jpg,0,0,1,2,3,0,train
1005,0508840_sc-174250.jpg,2,0,1,1,4,0,train
1006,0508834_sc-174250.jpg,2,0,0,0,2,0,val
1007,0508857_as-0086469.jpg,6,0,0,0,6,0,test
1008,0508833_sc-174250.jpg,2,0,1,0,3,0,train
1009,0508820_sc-201826.jpg,0,0,1,1,2,0,train
1010,0508813_sc-201826.jpg,2,0,0,0,2,0,train
1011,0508839_sc-174250.jpg,1,0,1,0,2,0,train
1012,0508814_sc-201826.jpg,2,0,0,0,2,0,train
1013,0508804_sc-111392.jpg,3,0,0,0,3,0,val
1014,0508816_sc-201826.jpg,2,0,1,0,3,0,test
1015,0508823_sc-201826.jpg,1,0,0,0,1,0,train
1016,0508801_as-0036134.jpg,4,1,0,0,5,0,train
1017,0508829_sc-149002.jpg,1,0,0,0,1,0,train
1018,0508811_sc-124828.jpg,1,0,0,0,1,0,train
1019,0508837_sc-174250.jpg,2,0,0,0,2,0,train
1020,0508802_as-0036134.jpg,2,1,0,0,3,0,val
1021,0508817_sc-201826.jpg,7,0,1,0,8,0,test
1022,0508853_sc-174250.jpg,1,0,0,0,1,0,train
1023,0508856_as-0086469.jpg,0,2,1,0,3,0,train
1024,0508812_sc-201826.jpg,2,0,1,0,3,0,train
1025,0508803_sc-111392.jpg,2,0,0,0,2,0,train
1026,0508854_as-3033952.jpg,1,0,1,0,2,0,train
1027,0508828_as-7031458.jpg,1,0,1,0,2,0,val
1028,0508807_sc-124828.jpg,2,1,3,1,7,0,test
1029,0508850_sc-174250.jpg,1,0,0,0,1,0,train
1030,0508845_sc-174250.jpg,1,1,0,0,2,0,train
1031,0508821_sc-201826.jpg,1,0,1,1,3,0,train
1032,0508815_sc-201826.jpg,6,1,1,1,9,0,train
1033,0508808_sc-124828.jpg,4,2,2,0,8,0,train
1034,0508826_as-0048928.jpg,4,0,0,0,4,0,val
1035,0508822_sc-201826.jpg,1,0,0,1,2,0,test
1036,0508848_sc-174250.jpg,2,0,0,0,2,0,train
1037,0508843_sc-174250.jpg,0,0,1,0,1,0,train
1038,0508842_sc-174250.jpg,0,1,1,0,2,0,train
1039,0508805_sc-124828.jpg,1,0,1,1,3,0,train
1040,0508806_sc-124828.jpg,1,0,0,0,1,0,train
1041,0508847_sc-174250.jpg,0,1,1,1,3,0,val
1042,0508852_sc-174250.jpg,4,1,0,0,5,0,test
1043,0508838_sc-174250.jpg,3,0,1,0,4,0,train
1044,0508849_sc-174250.jpg,2,0,0,0,2,0,train
1045,0508809_sc-124828.jpg,2,1,2,1,6,0,train
1046,0508819_sc-201826.jpg,3,0,0,0,3,0,train
1047,0508851_sc-174250.jpg,1,0,0,0,1,0,train
1048,0508827_as-3006179.jpg,1,0,0,1,2,0,val
1049,0508892_as-0018294.jpg,0,2,2,0,4,0,test
1050,0508916_sc-198433.jpg,0,0,1,0,1,0,train
1051,0508880_as-0037082.jpg,1,0,1,0,2,0,train
1052,0508872_as-2615015.jpg,6,0,1,0,7,0,train
1053,0508897_as-9094488.jpg,0,1,1,0,2,0,train
1054,0508910_sc-120568.jpg,1,0,0,0,1,0,train
1055,0508878_as-0037082.jpg,1,1,0,0,2,0,val
1056,0508902_as-0015380.jpg,2,0,1,0,3,0,test
1057,0508879_as-0037082.jpg,1,0,0,0,1,0,train
1058,0508915_as-0056845.jpg,1,0,1,0,2,0,train
1059,0508881_as-0037082.jpg,1,0,2,0,3,0,train
1060,0508886_as-3188655.jpg,1,0,0,2,3,0,train
1061,0508906_as-0015380.jpg,2,0,0,0,2,0,train
1062,0508866_as-0080912.jpg,1,0,0,0,1,0,val
1063,0508896_sc-1035787.jpg,3,1,0,0,4,0,test
1064,0508867_as-0017541.jpg,1,0,0,0,1,0,train
1065,0508911_as-9054636.jpg,3,1,1,0,5,0,train
1066,0508887_sc-153902.jpg,3,0,1,0,4,0,train
1067,0508888_sc-153902.jpg,1,0,2,0,3,0,train
1068,0508905_as-0015380.jpg,2,0,0,0,2,0,train
1069,0508903_as-0015380.jpg,1,0,0,0,1,0,val
1070,0508864_as-0080912.jpg,2,0,1,0,3,0,test
1071,0508882_as-0037082.jpg,8,0,0,0,8,0,train
1072,0508863_as-0080912.jpg,3,1,0,0,4,0,train
1073,0508917_sc-198433.jpg,0,0,0,1,1,0,train
1074,0508899_sc-216251.jpg,1,0,0,0,1,0,train
1075,0508898_sc-216251.jpg,4,3,0,3,10,0,train
1076,0508895_sc-1035787.jpg,1,0,0,0,1,0,val
1077,0508922_as-0012673.jpg,4,0,0,1,5,0,test
1078,0508900_as-7771632.jpg,6,0,3,2,11,0,train
1079,0508869_as-0020931.jpg,4,1,1,1,7,0,train
1080,0508870_as-7534026.jpg,1,0,0,0,1,0,train
1081,0508920_as-0012673.jpg,4,0,1,0,5,0,train
1082,0508904_as-0015380.jpg,1,0,1,0,2,0,train
1083,0508893_as-0018294.jpg,3,0,0,0,3,0,val
1084,0508891_as-0018294.jpg,10,0,0,0,10,0,test
1085,0508908_as-0015380.jpg,4,0,0,0,4,0,train
1086,0508921_as-0012673.jpg,1,0,1,0,2,0,train
1087,0508885_as-0037082.jpg,1,0,0,0,1,0,train
1088,0508861_as-0080912.jpg,2,0,0,0,2,0,train
1089,0508919_as-0012673.jpg,2,0,0,0,2,0,train
1090,0508871_as-2831909.jpg,1,0,0,0,1,0,val
1091,0508877_as-0037082.jpg,2,1,0,0,3,0,test
1092,0508890_as-0018294.jpg,2,1,1,1,5,0,train
1093,0508909_sc-120568.jpg,2,0,0,2,4,0,train
1094,0508907_as-0015380.jpg,1,0,0,0,1,0,train
1095,0508868_as-0020931.jpg,3,0,0,1,4,0,train
1096,0508960_as-0013233.jpg,3,2,2,0,7,0,train
1097,0508942_sc-217693.jpg,5,3,3,0,11,0,val
1098,0508944_as-0054953.jpg,1,0,0,0,1,0,test
1099,0508924_sc-199032.jpg,1,1,0,0,2,0,train
1100,0508932_as-0014346.jpg,1,0,1,0,2,0,train
1101,0508978_as-0043025.jpg,1,0,0,0,1,0,train
1102,0508927_sc-172561.jpg,1,0,0,0,1,0,train
1103,0508945_as-0054953.jpg,1,1,0,1,3,0,train
1104,0508925_sc-199032.jpg,2,0,0,0,2,0,val
1105,0508956_as-2789986.jpg,1,0,0,1,2,0,test
1106,0508939_sc-1023095.jpg,0,1,0,0,1,0,train
1107,0508940_sc-110055.jpg,3,1,0,0,4,0,train
1108,0508943_sc-217693.jpg,0,1,4,1,6,0,train
1109,0508931_as-0014346.jpg,1,0,0,0,1,0,train
1110,0508982_as-2848494.jpg,2,0,0,0,2,0,train
1111,0508928_sc-172561.jpg,2,0,0,0,2,0,val
1112,0508934_as-0014346.jpg,1,0,1,1,3,0,test
1113,0508955_as-2636210.jpg,1,0,1,0,2,0,train
1114,0508985_as-2971311.jpg,1,0,0,0,1,0,train
1115,0508949_as-0054953.jpg,6,0,0,0,6,0,train
1116,0508959_as-0013233.jpg,5,0,0,0,5,0,train
1117,0508941_as-3455144.jpg,1,0,0,0,1,0,train
1118,0508965_as-0090688.jpg,3,0,1,0,4,0,val
1119,0508975_sc-114395.jpg,3,0,0,0,3,0,test
1120,0508953_as-0076887.jpg,1,0,0,0,1,0,train
1121,0508933_as-0014346.jpg,5,1,0,0,6,0,train
1122,0508938_sc-1023095.jpg,1,1,1,1,4,0,train
1123,0508968_sc-217324.jpg,1,1,0,0,2,0,train
1124,0508967_sc-198989.jpg,0,1,1,2,4,0,train
1125,0508958_as-0013233.jpg,2,1,0,0,3,0,val
1126,0508976_sc-114395.jpg,3,0,0,0,3,0,test
1127,0508946_as-0054953.jpg,4,0,0,0,4,0,train
1128,0508984_as-2612051.jpg,3,1,2,2,8,0,train
1129,0508952_as-0076887.jpg,1,0,1,0,2,0,train
1130,0508957_as-0013233.jpg,1,0,0,1,2,0,train
1131,0508954_as-3039765.jpg,0,2,0,0,2,0,train
1132,0508962_as-7020234.jpg,4,0,0,0,4,0,val
1133,0508926_sc-172561.jpg,3,1,0,0,4,0,test
1134,0508974_sc-114395.jpg,0,1,0,0,1,0,train
1135,0508935_as-0018469.jpg,2,0,0,1,3,0,train
1136,0508966_as-7490275.jpg,1,1,2,0,4,0,train
1137,0508948_as-0054953.jpg,5,0,0,0,5,0,train
1138,0508971_as-0035159.jpg,2,0,0,1,3,0,train
1139,0508969_sc-174858.jpg,1,0,0,0,1,0,val
1140,0508980_as-3259717.jpg,0,1,0,0,1,0,test
1141,0508923_as-0012673.jpg,1,0,0,0,1,0,train
1142,0508961_as-0013233.jpg,2,0,0,0,2,0,train
1143,0508937_as-2630114.jpg,1,0,0,0,1,0,train
1144,0508977_as-0043025.jpg,1,0,1,1,3,0,train
1145,0508970_sc-174858.jpg,2,0,0,0,2,0,train
1146,0508947_as-0054953.jpg,0,1,1,0,2,0,val
1147,0508981_as-3291236.jpg,0,1,1,0,2,0,test
1148,0508979_as-2625587.jpg,1,0,0,0,1,0,train
1149,0508973_as-3292442.jpg,4,1,2,0,7,0,train
1150,0508992_sc-112064.jpg,1,0,0,0,1,0,train
1151,0508993_sc-112064.jpg,2,0,1,0,3,0,train
1152,0508986_sc-112064.jpg,1,0,0,0,1,0,train
1153,0508988_sc-112064.jpg,2,0,1,0,3,0,val
1154,0508987_sc-112064.jpg,3,1,0,2,6,0,test
1155,0508990_sc-112064.jpg,3,0,0,0,3,0,train
1156,0509001_sc-105039.jpg,5,2,1,0,8,0,train
1157,0508998_sc-211223.jpg,3,0,2,0,5,0,train
1158,0509002_sc-105039.jpg,1,0,1,1,3,0,train
1159,0508995_as-2639513.jpg,2,0,0,0,2,0,train
1160,0508997_as-2776786.jpg,3,0,1,0,4,0,val
1161,0508996_as-2776786.jpg,5,3,0,0,8,0,test
1162,0508999_sc-211223.jpg,1,0,0,0,1,0,train
1163,0509000_sc-105039.jpg,7,1,3,0,11,0,train
1164,0509004_sc-105039.jpg,2,0,1,1,4,0,train
1165,0509006_sc-105039.jpg,4,1,3,0,8,0,train
1166,0509007_sc-105039.jpg,2,0,1,0,3,0,train
1167,0509005_sc-105039.jpg,17,0,0,0,17,0,val
1168,0509003_sc-105039.jpg,2,0,0,0,2,0,test
1169,0509014_sc-105039.jpg,2,0,1,1,4,0,train
1170,0509012_sc-105039.jpg,4,0,0,0,4,0,train
1171,0509016_sc-1002650.jpg,4,0,2,1,7,0,train
1172,0509013_sc-105039.jpg,3,0,0,1,4,0,train
1173,0509015_sc-1002650.jpg,0,0,0,1,1,0,train
1174,0509027_sc-210590.jpg,0,0,1,0,1,0,val
1175,0509051_sc-146335.jpg,3,1,1,1,6,0,test
1176,0509061_sc-1002666.jpg,0,0,0,1,1,0,train
1177,0509055_as-0000630.jpg,1,2,1,1,5,0,train
1178,0509054_as-7340185.jpg,1,0,0,0,1,0,train
1179,0509020_sc-220566.jpg,0,0,2,0,2,0,train
1180,0509038_sc-1013447.jpg,3,0,0,1,4,0,train
1181,0509024_as-0076611.jpg,1,0,0,1,2,0,val
1182,0509046_sc-123594.jpg,1,0,0,0,1,0,test
1183,0509049_as-7896693.jpg,0,0,1,0,1,0,train
1184,0509031_sc-173895.jpg,1,0,0,0,1,0,train
1185,0509052_as-9085884.jpg,1,0,0,0,1,0,train
1186,0509030_sc-173895.jpg,0,0,0,1,1,0,train
1187,0509045_sc-123594.jpg,2,0,0,0,2,0,train
1188,0509035_as-0028245.jpg,2,0,0,0,2,0,val
1189,0509053_sc-1041522.jpg,0,0,1,0,1,0,test
1190,0509047_sc-153763.jpg,2,0,3,2,7,0,train
1191,0509059_sc-1002666.jpg,4,2,0,1,7,0,train
1192,0509019_sc-220566.jpg,1,2,1,0,4,0,train
1193,0509026_sc-210590.jpg,1,0,1,0,2,0,train
1194,0509042_as-0083629.jpg,0,1,0,0,1,0,train
1195,0509057_as-2818712.jpg,1,0,2,0,3,0,val
1196,0509023_as-0076611.jpg,1,0,0,0,1,0,test
1197,0509050_sc-146335.jpg,5,3,3,0,11,0,train
1198,0509040_as-2639043.jpg,3,0,1,0,4,0,train
1199,0509036_sc-1013447.jpg,1,3,0,0,4,0,train
1200,0509028_sc-173895.jpg,8,0,1,1,10,0,train
1201,0509025_as-0076611.jpg,1,0,0,0,1,0,train
1202,0509060_sc-1002666.jpg,2,0,0,0,2,0,val
1203,0509022_as-0076611.jpg,1,0,2,0,3,0,test
1204,0509029_sc-173895.jpg,1,1,1,0,3,0,train
1205,0509039_as-3340882.jpg,2,0,0,0,2,0,train
1206,0509018_sc-229258.jpg,2,1,0,0,3,0,train
1207,0509021_sc-220566.jpg,3,0,1,0,4,0,train
1208,0509056_as-0000630.jpg,3,0,2,1,6,0,train
1209,0509037_sc-1013447.jpg,1,0,0,0,1,0,val
1210,0509106_as-0034172.jpg,4,0,0,0,4,0,test
1211,0509086_as-0086570.jpg,1,0,0,1,2,0,train
1212,0509090_as-7621656.jpg,1,0,0,0,1,0,train
1213,0509070_sc-1010150.jpg,5,3,0,0,8,0,train
1214,0509088_sc-196040.jpg,1,0,0,0,1,0,train
1215,0509065_as-0085484.jpg,1,1,1,0,3,0,train
1216,0509116_as-0019807.jpg,1,0,1,1,3,0,val
1217,0509117_as-0019807.jpg,2,0,1,0,3,0,test
1218,0509082_as-7299325.jpg,0,1,0,0,1,0,train
1219,0509085_as-0086570.jpg,1,0,0,0,1,0,train
1220,0509099_sc-1003750.jpg,2,0,0,0,2,0,train
1221,0509112_sc-220841.jpg,2,0,1,1,4,0,train
1222,0509113_sc-220841.jpg,5,0,0,1,6,0,train
1223,0509107_sc-209335.jpg,3,1,0,0,4,0,val
1224,0509100_sc-1003750.jpg,2,0,0,0,2,0,test
1225,0509110_as-3262237.jpg,1,0,0,0,1,0,train
1226,0509118_as-0019807.jpg,0,0,1,0,1,0,train
1227,0509102_as-0034172.jpg,4,0,1,0,5,0,train
1228,0509091_sc-178221.jpg,2,3,0,0,5,0,train
1229,0509068_as-3081702.jpg,0,0,1,1,2,0,train
1230,0509103_as-0034172.jpg,4,3,2,1,10,0,val
1231,0509108_as-3331875.jpg,4,0,0,0,4,0,test
1232,0509087_sc-196040.jpg,2,0,0,0,2,0,train
1233,0509080_as-0077479.jpg,1,0,1,0,2,0,train
1234,0509114_as-3072609.jpg,1,0,2,1,4,0,train
1235,0509071_sc-1010150.jpg,7,0,2,0,9,0,train
1236,0509104_as-0034172.jpg,3,2,2,0,7,0,train
1237,0509093_sc-178221.jpg,2,0,0,0,2,0,val
1238,0509074_sc-149851.jpg,2,0,0,4,6,0,test
1239,0509079_as-0077479.jpg,2,1,0,0,3,0,train
1240,0509105_as-0034172.jpg,5,1,1,1,8,0,train
1241,0509098_sc-1003750.jpg,1,1,0,0,2,0,train
1242,0509092_sc-178221.jpg,2,0,0,0,2,0,train
1243,0509101_sc-1003750.jpg,2,0,0,0,2,0,train
1244,0509089_sc-196040.jpg,1,0,1,1,3,0,val
1245,0509078_as-0077479.jpg,2,0,1,1,4,0,test
1246,0509066_as-0085484.jpg,5,0,0,1,6,0,train
1247,0509094_sc-178221.jpg,3,0,2,0,5,0,train
1248,0509172_sc-1026932.jpg,1,2,1,0,4,0,train
1249,0509154_as-0051443.jpg,1,0,0,0,1,0,train
1250,0509134_sc-154195.jpg,1,1,0,0,2,0,train
1251,0509128_as-3284364.jpg,1,0,0,0,1,0,val
1252,0509159_as-3031939.jpg,0,1,0,0,1,0,test
1253,0509164_as-3130067.jpg,2,1,0,0,3,0,train
1254,0509133_as-2688856.jpg,1,0,0,0,1,0,train
1255,0509119_as-0019807.jpg,1,0,0,1,2,0,train
1256,0509141_sc-103089.jpg,1,1,0,0,2,0,train
1257,0509180_as-0064157.jpg,1,0,1,0,2,0,train
1258,0509176_as-0049642.jpg,3,0,0,1,4,0,val
1259,0509146_as-0000367.jpg,2,0,2,1,5,0,test
1260,0509161_as-3387127.jpg,1,0,0,0,1,0,train
1261,0509181_as-0064157.jpg,0,0,0,1,1,0,train
1262,0509142_sc-103089.jpg,1,0,0,1,2,0,train
1263,0509129_sc-219953.jpg,2,0,0,0,2,0,train
1264,0509156_as-0051443.jpg,10,0,0,0,10,0,train
1265,0509166_sc-135975.jpg,1,0,4,1,6,0,val
1266,0509153_as-0051443.jpg,1,0,0,0,1,0,test
1267,0509175_as-0049642.jpg,1,0,0,0,1,0,train
1268,0509169_sc-1028900.jpg,3,0,0,0,3,0,train
1269,0509167_sc-135975.jpg,3,1,1,2,7,0,train
1270,0509125_sc-228904.jpg,3,3,0,0,6,0,train
1271,0509137_sc-154195.jpg,7,1,0,0,8,0,train
1272,0509155_as-0051443.jpg,1,0,0,0,1,0,val
1273,0509184_as-7896568.jpg,1,4,1,1,7,0,test
1274,0509122_as-7338086.jpg,1,0,0,0,1,0,train
1275,0509147_as-0000367.jpg,0,1,0,0,1,0,train
1276,0509160_as-3230541.jpg,1,0,0,0,1,0,train
1277,0509152_as-0051443.jpg,5,0,1,1,7,0,train
1278,0509151_as-0051443.jpg,1,0,1,0,2,0,train
1279,0509177_as-0049642.jpg,1,0,0,0,1,0,val
1280,0509136_sc-154195.jpg,1,0,0,0,1,0,test
1281,0509127_sc-228904.jpg,2,0,0,0,2,0,train
1282,0509135_sc-154195.jpg,1,1,0,0,2,0,train
1283,0509163_as-0000295.jpg,2,0,1,0,3,0,train
1284,0509124_as-3232158.jpg,1,0,0,0,1,0,train
1285,0509171_sc-1026932.jpg,8,1,2,0,11,0,train
1286,0509149_as-0051443.jpg,1,1,0,0,2,0,val
1287,0509170_as-9089897.jpg,3,0,0,0,3,0,test
1288,0509186_sc-145408.jpg,2,2,2,1,7,0,train
1289,0509168_sc-1033629.jpg,2,0,0,0,2,0,train
1290,0509126_sc-228904.jpg,1,0,1,0,2,0,train
1291,0509183_as-7420768.jpg,1,0,2,0,3,0,train
1292,0509138_sc-154195.jpg,1,0,0,4,5,0,train
1293,0509178_as-3354330.jpg,2,0,0,0,2,0,val
1294,0509123_sc-225915.jpg,3,0,0,0,3,0,test
1295,0509143_sc-103089.jpg,11,0,0,0,11,0,train
1296,0509150_as-0051443.jpg,2,0,0,0,2,0,train
1297,0509239_sc-161128.jpg,2,2,0,2,6,0,train
1298,0509190_as-3193959.jpg,1,0,1,0,2,0,train
1299,0509263_sc-1017706.jpg,4,0,0,0,4,0,train
1300,0509211_sc-206301.jpg,1,0,0,0,1,0,val
1301,0509210_sc-206301.jpg,1,0,0,0,1,0,test
1302,0509236_as-2541497.jpg,1,0,0,0,1,0,train
1303,0509207_as-0032951.jpg,4,2,1,1,8,0,train
1304,0509194_sc-201067.jpg,1,0,2,1,4,0,train
1305,0509213_sc-206301.jpg,1,0,1,1,3,0,train
1306,0509222_sc-1021585.jpg,2,0,1,0,3,0,train
1307,0509195_sc-201067.jpg,2,1,0,0,3,0,val
1308,0509219_sc-206301.jpg,4,1,1,0,6,0,test
1309,0509259_as-2636267.jpg,1,0,0,0,1,0,train
1310,0509243_sc-161128.jpg,1,0,0,0,1,0,train
1311,0509208_as-0032951.jpg,4,0,0,0,4,0,train
1312,0509199_as-3360174.jpg,3,0,0,0,3,0,train
1313,0509226_sc-142815.jpg,1,0,0,0,1,0,train
1314,0509227_sc-142815.jpg,1,0,1,0,2,0,val
1315,0509251_as-0098836.jpg,1,0,0,0,1,0,test
1316,0509238_sc-161128.jpg,1,0,1,0,2,0,train
1317,0509189_sc-145408.jpg,2,1,2,1,6,0,train
1318,0509209_as-0032951.jpg,5,1,1,1,8,0,train
1319,0509230_sc-1029510.jpg,1,0,0,0,1,0,train
1320,0509206_as-2818620.jpg,11,0,1,0,12,0,train
1321,0509237_sc-161128.jpg,8,0,0,0,8,0,val
1322,0509260_sc-124619.jpg,1,0,0,0,1,0,test
1323,0509244_as-2792568.jpg,2,0,0,0,2,0,train
1324,0509261_sc-1017706.jpg,1,0,1,1,3,0,train
1325,0509223_sc-1021585.jpg,4,0,0,0,4,0,train
1326,0509231_sc-1029510.jpg,1,0,0,0,1,0,train
1327,0509217_sc-206301.jpg,0,1,0,0,1,0,train
1328,0509220_sc-157681.jpg,3,1,0,0,4,0,val
1329,0509205_as-2746011.jpg,1,0,0,1,2,0,test
1330,0509218_sc-206301.jpg,1,1,1,0,3,0,train
1331,0509252_as-0098836.jpg,0,0,0,1,1,0,train
1332,0509229_sc-1029510.jpg,3,0,1,2,6,0,train
1333,0509215_sc-206301.jpg,0,0,1,0,1,0,train
1334,0509256_as-0076853.jpg,2,0,1,0,3,0,train
1335,0509201_as-7038356.jpg,4,1,2,3,10,0,val
1336,0509196_sc-201067.jpg,0,2,1,0,3,0,test
1337,0509241_sc-161128.jpg,1,0,0,0,1,0,train
1338,0509250_as-0098836.jpg,0,0,2,0,2,0,train
1339,0509240_sc-161128.jpg,14,0,0,0,14,0,train
1340,0509225_sc-142815.jpg,1,0,0,0,1,0,train
1341,0509245_as-7562931.jpg,3,0,0,0,3,0,train
1342,0509257_as-0076853.jpg,2,0,0,0,2,0,val
1343,0509193_sc-201067.jpg,5,0,1,1,7,0,test
1344,0509188_sc-145408.jpg,3,1,0,0,4,0,train
1345,0509221_as-2711945.jpg,3,0,1,0,4,0,train
1346,0509192_sc-201067.jpg,1,0,0,0,1,0,train
1347,0509228_as-5039638.jpg,2,0,0,0,2,0,train
1348,0509242_sc-161128.jpg,1,0,0,1,2,0,train
1349,0509191_sc-201067.jpg,2,0,0,0,2,0,val
1350,0509246_as-7153728.jpg,2,0,0,1,3,0,test
1351,0509254_sc-133718.jpg,0,1,0,0,1,0,train
1352,0509253_as-0098836.jpg,1,0,0,0,1,0,train
1353,0509216_sc-206301.jpg,10,0,3,1,14,0,train
1354,0509235_sc-205159.jpg,1,0,0,1,2,0,train
1355,0509212_sc-206301.jpg,2,3,0,0,5,0,train
1356,0509187_sc-145408.jpg,11,0,2,0,13,0,val
1357,0509214_sc-206301.jpg,0,1,0,0,1,0,test
1358,0509203_as-2524764.jpg,1,1,0,0,2,0,train
1359,0509204_as-3497234.jpg,2,0,0,0,2,0,train
1360,0509301_as-0054044.jpg,1,0,0,0,1,0,train
1361,0509297_as-0054044.jpg,1,0,1,0,2,0,train
1362,0509265_as-0053526.jpg,2,0,0,0,2,0,train
1363,0509289_sc-222506.jpg,2,1,0,0,3,0,val
1364,0509318_sc-137720.jpg,0,2,0,0,2,0,test
1365,0509306_sc-1033023.jpg,4,0,0,0,4,0,train
1366,0509327_sc-187429.jpg,0,0,0,1,1,0,train
1367,0509319_sc-137720.jpg,4,0,1,1,6,0,train
1368,0509320_sc-187429.jpg,3,0,0,0,3,0,train
1369,0509322_sc-187429.jpg,0,1,1,0,2,0,train
1370,0509292_as-2702652.jpg,2,0,0,0,2,0,val
1371,0509295_sc-151511.jpg,2,0,0,0,2,0,test
1372,0509309_as-2777087.jpg,2,0,0,0,2,0,train
1373,0509286_sc-196515.jpg,1,1,0,0,2,0,train
1374,0509305_sc-1033023.jpg,3,2,1,0,6,0,train
1375,0509315_sc-137720.jpg,0,0,1,0,1,0,train
1376,0509323_sc-187429.jpg,1,0,0,0,1,0,train
1377,0509290_sc-222506.jpg,2,1,1,0,4,0,val
1378,0509304_as-0054044.jpg,1,0,0,0,1,0,test
1379,0509270_sc-223162.jpg,2,0,1,0,3,0,train
1380,0509266_as-0053526.jpg,1,2,0,0,3,0,train
1381,0509267_as-0053526.jpg,7,0,0,0,7,0,train
1382,0509328_as-7050444.jpg,7,0,1,0,8,0,train
1383,0509325_sc-187429.jpg,6,0,0,1,7,0,train
1384,0509303_as-0054044.jpg,3,0,0,0,3,0,val
1385,0509308_as-3052081.jpg,2,0,0,0,2,0,test
1386,0509285_as-2972561.jpg,2,0,1,0,3,0,train
1387,0509299_as-0054044.jpg,2,0,0,1,3,0,train
1388,0509274_as-0046427.jpg,2,0,1,1,4,0,train
1389,0509278_as-0046427.jpg,0,1,0,0,1,0,train
1390,0509302_as-0054044.jpg,6,0,0,0,6,0,train
1391,0509275_as-0046427.jpg,3,0,0,1,4,0,val
1392,0509296_sc-151511.jpg,0,1,0,0,1,0,test
1393,0509272_sc-223162.jpg,1,1,1,1,4,0,train
1394,0509326_sc-187429.jpg,1,1,0,0,2,0,train
1395,0509282_as-0099772.jpg,2,0,0,1,3,0,train
1396,0509271_sc-223162.jpg,2,0,1,0,3,0,train
1397,0509284_as-3196157.jpg,1,0,1,1,3,0,train
1398,0509269_sc-223162.jpg,5,1,0,0,6,0,val
1399,0509316_sc-137720.jpg,6,0,1,0,7,0,test
1400,0509291_as-9010659.jpg,1,0,1,0,2,0,train
1401,0509300_as-0054044.jpg,1,0,0,0,1,0,train
1402,0509281_as-0099772.jpg,8,0,0,0,8,0,train
1403,0509288_as-7222855.jpg,0,2,1,0,3,0,train
1404,0509280_as-0099772.jpg,1,0,0,0,1,0,train
1405,0509283_as-0099772.jpg,4,0,0,1,5,0,val
1406,0509277_as-0046427.jpg,1,0,1,0,2,0,test
1407,0509279_as-0046427.jpg,1,1,0,0,2,0,train
1408,0509293_sc-151511.jpg,1,0,0,0,1,0,train
1409,0509276_as-0046427.jpg,5,3,1,1,10,0,train
1410,0509268_sc-223162.jpg,0,1,1,1,3,0,train
1411,0509294_sc-151511.jpg,0,1,0,0,1,0,train
1412,0509314_sc-118922.jpg,1,0,0,0,1,0,val
1413,0509273_as-0046427.jpg,0,1,0,0,1,0,test
1414,0509264_as-0053526.jpg,4,0,0,0,4,0,train
1415,0509298_as-0054044.jpg,3,1,2,4,10,0,train
1416,0509329_as-3245561.jpg,3,0,0,0,3,0,train
1417,0509307_as-3050263.jpg,1,4,2,0,7,0,train
1418,0509373_sc-199690.jpg,1,0,1,0,2,0,train
1419,0509381_sc-134061.jpg,1,1,2,1,5,0,val
1420,0509363_as-2599788.jpg,0,0,0,2,2,0,test
1421,0509378_as-2698672.jpg,3,0,1,2,6,0,train
1422,0509376_sc-228112.jpg,1,0,1,1,3,0,train
1423,0509337_sc-199050.jpg,1,1,2,0,4,0,train
1424,0509403_as-0036851.jpg,3,0,0,0,3,0,train
1425,0509340_sc-207188.jpg,0,2,1,0,3,0,train
1426,0509333_sc-195846.jpg,1,0,0,0,1,0,val
1427,0509352_as-0074101.jpg,1,3,2,0,6,0,test
1428,0509362_as-0062751.jpg,1,0,0,0,1,0,train
1429,0509356_sc-159515.jpg,2,0,0,0,2,0,train
1430,0509383_sc-110196.jpg,2,0,0,0,2,0,train
1431,0509339_sc-207188.jpg,2,0,0,1,3,0,train
1432,0509349_as-0074101.jpg,4,0,1,0,5,0,train
1433,0509371_sc-1023536.jpg,4,0,0,0,4,0,val
1434,0509406_as-0036851.jpg,6,0,0,0,6,0,test
1435,0509348_as-0074101.jpg,4,0,0,0,4,0,train
1436,0509398_sc-207001.jpg,1,0,1,0,2,0,train
1437,0509343_sc-207188.jpg,2,1,0,0,3,0,train
1438,0509411_sc-210689.jpg,1,1,1,0,3,0,train
1439,0509355_sc-159515.jpg,1,1,0,0,2,0,train
1440,0509377_sc-228112.jpg,2,0,0,0,2,0,val
1441,0509359_as-0062751.jpg,0,0,0,1,1,0,test
1442,0509401_sc-207001.jpg,1,0,0,0,1,0,train
1443,0509379_sc-213460.jpg,1,0,0,0,1,0,train
1444,0509400_sc-207001.jpg,7,0,0,0,7,0,train
1445,0509392_as-0058958.jpg,1,0,1,1,3,0,train
1446,0509408_as-0036851.jpg,0,1,1,0,2,0,train
1447,0509358_as-0062751.jpg,1,0,1,2,4,0,val
1448,0509342_sc-207188.jpg,2,1,1,0,4,0,test
1449,0509354_sc-159515.jpg,0,0,0,1,1,0,train
1450,0509353_sc-159515.jpg,3,0,0,0,3,0,train
1451,0509370_sc-1023536.jpg,3,0,0,0,3,0,train
1452,0509365_sc-216443.jpg,2,2,2,1,7,0,train
1453,0509351_as-0074101.jpg,3,2,1,1,7,0,train
1454,0509402_as-0036851.jpg,3,2,0,0,5,0,val
1455,0509399_sc-207001.jpg,1,0,0,0,1,0,test
1456,0509389_as-0058958.jpg,1,0,0,1,2,0,train
1457,0509385_sc-110196.jpg,5,2,1,2,10,0,train
1458,0509397_sc-207001.jpg,2,0,1,1,4,0,train
1459,0509384_sc-110196.jpg,1,0,0,0,1,0,train
1460,0509360_as-0062751.jpg,2,0,1,0,3,0,train
1461,0509375_sc-228112.jpg,0,1,2,0,3,0,val
1462,0509404_as-0036851.jpg,6,0,0,0,6,0,test
1463,0509338_sc-207188.jpg,1,1,1,0,3,0,train
1464,0509346_sc-117630.jpg,2,0,0,0,2,0,train
1465,0509350_as-0074101.jpg,1,0,0,0,1,0,train
1466,0509369_sc-1023536.jpg,2,0,1,1,4,0,train
1467,0509331_sc-195846.jpg,1,0,1,1,3,0,train
1468,0509380_sc-134061.jpg,1,0,0,0,1,0,val
1469,0509330_sc-195846.jpg,2,0,0,1,3,0,test
1470,0509366_sc-216443.jpg,2,0,0,1,3,0,train
1471,0509372_sc-1023536.jpg,6,0,0,0,6,0,train
1472,0509345_sc-117630.jpg,6,0,0,0,6,0,train
1473,0509407_as-0036851.jpg,3,1,0,0,4,0,train
1474,0509341_sc-207188.jpg,4,2,0,1,7,0,train
1475,0509391_as-0058958.jpg,1,1,1,0,3,0,val
1476,0509374_sc-199690.jpg,1,0,1,0,2,0,test
1477,0509368_sc-1023536.jpg,0,0,2,0,2,0,train
1478,0509336_as-0000109.jpg,1,0,0,0,1,0,train
1479,0509396_sc-207001.jpg,1,0,0,0,1,0,train
1480,0509388_as-0058958.jpg,1,0,0,1,2,0,train
1481,0509382_sc-134061.jpg,0,0,0,2,2,0,train
1482,0509364_sc-216443.jpg,1,1,2,1,5,0,val
1483,0509332_sc-195846.jpg,0,1,0,0,1,0,test
1484,0509418_as-2687334.jpg,1,0,0,0,1,0,train
1485,0509454_sc-141219.jpg,1,0,0,0,1,0,train
1486,0509434_as-0078137.jpg,1,0,0,0,1,0,train
1487,0509441_sc-1026393.jpg,1,0,0,0,1,0,train
1488,0509412_sc-142809.jpg,3,1,0,0,4,0,train
1489,0509455_sc-141219.jpg,1,0,0,0,1,0,val
1490,0509415_sc-1026295.jpg,0,1,0,0,1,0,test
1491,0509442_sc-133579.jpg,1,0,2,0,3,0,train
1492,0509436_as-9078062.jpg,1,1,1,1,4,0,train
1493,0509433_as-0078137.jpg,2,2,1,0,5,0,train
1494,0509446_sc-1020902.jpg,1,2,1,0,4,0,train
1495,0509416_sc-1026295.jpg,1,0,1,1,3,0,train
1496,0509423_as-3306112.jpg,2,0,0,0,2,0,val
1497,0509439_sc-129718.jpg,1,0,0,0,1,0,test
1498,0509430_as-0078137.jpg,1,1,1,0,3,0,train
1499,0509421_as-7332819.jpg,4,3,0,2,9,0,train
1500,0509460_as-0047356.jpg,1,0,1,0,2,0,train
1501,0509447_sc-1020902.jpg,1,3,0,0,4,0,train
1502,0509445_sc-133579.jpg,2,0,0,0,2,0,train
1503,0509457_as-0047356.jpg,2,0,0,0,2,0,val
1504,0509450_sc-1020902.jpg,1,1,0,1,3,0,test
1505,0509424_as-0078137.jpg,1,1,1,0,3,0,train
1506,0509451_sc-1020902.jpg,1,0,0,0,1,0,train
1507,0509417_as-7555427.jpg,4,1,5,0,10,0,train
1508,0509440_as-3435957.jpg,1,0,0,0,1,0,train
1509,0509425_as-0078137.jpg,5,0,1,0,6,0,train
1510,0509414_as-2654676.jpg,1,0,2,0,3,0,val
1511,0509456_as-0047356.jpg,8,0,0,1,9,0,test
1512,0509435_as-0078137.jpg,1,0,0,0,1,0,train
1513,0509443_sc-133579.jpg,1,0,0,0,1,0,train
1514,0509431_as-0078137.jpg,1,0,0,0,1,0,train
1515,0509432_as-0078137.jpg,2,0,0,0,2,0,train
1516,0509463_as-0082108.jpg,3,0,0,0,3,0,train
1517,0509449_sc-1020902.jpg,4,0,1,3,8,0,val
1518,0509459_as-0047356.jpg,1,0,0,0,1,0,test
1519,0509413_sc-142754.jpg,2,0,0,0,2,0,train
1520,0509437_sc-129718.jpg,2,0,0,0,2,0,train
1521,0509458_as-0047356.jpg,1,1,0,0,2,0,train
1522,0509438_sc-129718.jpg,1,0,2,1,4,0,train
1523,0509426_as-0078137.jpg,3,0,0,1,4,0,train
1524,0509444_sc-133579.jpg,1,1,0,0,2,0,val
1525,0509494_as-0052320.jpg,2,0,1,1,4,0,test
1526,0509496_as-0052320.jpg,3,1,2,0,6,0,train
1527,0509475_as-0000871.jpg,2,0,1,0,3,0,train
1528,0509525_sc-160823.jpg,3,0,1,0,4,0,train
1529,0509484_as-0052320.jpg,1,0,0,0,1,0,train
1530,0509526_as-3324906.jpg,0,1,0,0,1,0,train
1531,0509480_sc-135153.jpg,1,0,0,1,2,0,val
1532,0509493_as-0052320.jpg,3,0,0,0,3,0,test
1533,0509489_as-0052320.jpg,1,1,0,0,2,0,train
1534,0509474_as-0000871.jpg,3,0,0,0,3,0,train
1535,0509519_as-0016732.jpg,5,1,0,0,6,0,train
1536,0509464_as-3090933.jpg,3,0,1,0,4,0,train
1537,0509490_as-0052320.jpg,2,2,1,0,5,0,train
1538,0509477_sc-135153.jpg,3,0,0,0,3,0,val
1539,0509507_as-2502088.jpg,2,0,0,0,2,0,test
1540,0509521_as-2919313.jpg,1,0,0,0,1,0,train
1541,0509516_as-0016732.jpg,1,0,0,0,1,0,train
1542,0509469_sc-1009709.jpg,7,4,3,2,16,0,train
1543,0509505_sc-190657.jpg,2,0,0,0,2,0,train
1544,0509508_as-0087854.jpg,0,1,0,0,1,0,train
1545,0509518_as-0016732.jpg,1,0,0,0,1,0,val
1546,0509492_as-0052320.jpg,1,0,0,0,1,0,test
1547,0509528_sc-1034211.jpg,2,0,1,0,3,0,train
1548,0509466_sc-107377.jpg,5,0,1,3,9,0,train
1549,0509514_as-0052777.jpg,1,1,0,3,5,0,train
1550,0509495_as-0052320.jpg,3,0,2,0,5,0,train
1551,0509499_as-0043537.jpg,2,0,0,0,2,0,train
1552,0509533_sc-220147.jpg,5,0,0,1,6,0,val
1553,0509472_as-3499765.jpg,1,0,0,0,1,0,test
1554,0509510_as-7555926.jpg,4,0,0,0,4,0,train
1555,0509504_sc-190657.jpg,6,0,0,0,6,0,train
1556,0509486_as-0052320.jpg,0,1,0,0,1,0,train
1557,0509497_as-0052320.jpg,4,0,0,1,5,0,train
1558,0509478_sc-135153.jpg,1,0,0,0,1,0,train
1559,0509530_sc-130081.jpg,1,1,0,0,2,0,val
1560,0509523_sc-160823.jpg,1,0,0,0,1,0,test
1561,0509501_as-2562097.jpg,0,1,0,0,1,0,train
1562,0509531_sc-211503.jpg,5,0,0,0,5,0,train
1563,0509500_as-0043537.jpg,2,0,0,0,2,0,train
1564,0509468_sc-147723.jpg,2,0,1,0,3,0,train
1565,0509527_as-2613253.jpg,2,0,0,0,2,0,train
1566,0509509_as-0087854.jpg,2,0,0,0,2,0,val
1567,0509483_as-0052320.jpg,1,0,0,0,1,0,test
1568,0509524_sc-160823.jpg,2,0,0,0,2,0,train
1569,0509488_as-0052320.jpg,1,0,0,1,2,0,train
1570,0509471_sc-215567.jpg,2,0,0,0,2,0,train
1571,0509476_as-0000871.jpg,4,0,0,0,4,0,train
1572,0509513_as-0052777.jpg,1,0,1,0,2,0,train
1573,0509487_as-0052320.jpg,1,0,0,0,1,0,val
1574,0509522_as-3281207.jpg,1,0,0,0,1,0,test
1575,0509532_sc-211503.jpg,2,0,0,0,2,0,train
1576,0509529_sc-1034211.jpg,2,0,1,0,3,0,train
1577,0509512_as-0052777.jpg,3,0,0,0,3,0,train
1578,0509485_as-0052320.jpg,4,0,0,1,5,0,train
1579,0509473_as-0000871.jpg,3,0,0,0,3,0,train
1580,0509467_as-7699686.jpg,1,0,0,0,1,0,val
1581,0509465_sc-107377.jpg,1,0,0,1,2,0,test
1582,0509517_as-0016732.jpg,2,2,1,1,6,0,train
1583,0509576_as-7547193.jpg,1,0,0,0,1,0,train
1584,0509541_as-7541011.jpg,2,0,0,0,2,0,train
1585,0509539_as-0016325.jpg,2,0,0,0,2,0,train
1586,0509549_as-0022756.jpg,1,0,0,1,2,0,train
1587,0509575_sc-159155.jpg,3,1,1,2,7,0,val
1588,0509578_sc-175194.jpg,1,0,0,0,1,0,test
1589,0509546_as-0093159.jpg,1,0,0,1,2,0,train
1590,0509567_as-0021062.jpg,0,2,3,0,5,0,train
1591,0509582_as-7971811.jpg,4,0,0,0,4,0,train
1592,0509586_as-3048941.jpg,4,0,0,1,5,0,train
1593,0509556_sc-109694.jpg,7,0,0,0,7,0,train
1594,0509551_as-3262471.jpg,3,0,0,0,3,0,val
1595,0509554_sc-109694.jpg,2,0,0,0,2,0,test
1596,0509589_as-2852406.jpg,1,1,0,0,2,0,train
1597,0509577_sc-175194.jpg,0,1,0,0,1,0,train
1598,0509562_as-3063192.jpg,4,0,1,0,5,0,train
1599,0509538_as-0016325.jpg,1,1,0,0,2,0,train
1600,0509545_as-0093159.jpg,2,0,0,0,2,0,train
1601,0509559_sc-109694.jpg,1,1,1,0,3,0,val
1602,0509585_as-2967348.jpg,2,0,0,0,2,0,test
1603,0509588_as-9002795.jpg,0,0,1,0,1,0,train
1604,0509587_sc-191362.jpg,1,0,0,0,1,0,train
1605,0509540_as-2789136.jpg,2,0,0,0,2,0,train
1606,0509555_sc-109694.jpg,3,0,0,0,3,0,train
1607,0509553_as-7855948.jpg,10,0,1,0,11,0,train
1608,0509548_as-0022756.jpg,4,0,2,1,7,0,val
1609,0509573_as-0017060.jpg,1,0,0,0,1,0,test
1610,0509565_as-0063070.jpg,0,1,0,0,1,0,train
1611,0509561_as-3384235.jpg,2,0,0,0,2,0,train
1612,0509547_as-0093159.jpg,5,0,0,0,5,0,train
1613,0509584_as-2969334.jpg,1,1,2,0,4,0,train
1614,0509574_as-0066735.jpg,1,0,0,0,1,0,train
1615,0509569_as-9008081.jpg,8,1,0,0,9,0,val
1616,0509583_as-2779831.jpg,4,0,1,0,5,0,test
1617,0509535_sc-211017.jpg,1,0,0,0,1,0,train
1618,0509560_sc-109694.jpg,1,0,0,0,1,0,train
1619,0509544_as-0093159.jpg,1,1,1,1,4,0,train
1620,0509581_sc-175194.jpg,1,0,0,0,1,0,train
1621,0509580_sc-175194.jpg,0,0,2,0,2,0,train
1622,0509609_sc-1020630.jpg,2,0,1,1,4,0,val
1623,0509633_sc-205326.jpg,3,1,2,0,6,0,test
1624,0509614_sc-1031476.jpg,3,0,0,1,4,0,train
1625,0509601_sc-176051.jpg,1,0,0,1,2,0,train
1626,0509620_sc-198844.jpg,1,0,0,0,1,0,train
1627,0509612_sc-139049.jpg,2,0,0,1,3,0,train
1628,0509617_as-9084041.jpg,5,0,0,0,5,0,train
1629,0509598_as-0065844.jpg,1,1,0,0,2,0,val
1630,0509645_as-0043184.jpg,2,1,0,0,3,0,test
1631,0509591_sc-221183.jpg,7,0,1,1,9,0,train
1632,0509608_sc-176051.jpg,2,1,0,0,3,0,train
1633,0509651_sc-200476.jpg,2,0,0,0,2,0,train
1634,0509590_sc-221183.jpg,2,0,0,0,2,0,train
1635,0509621_sc-198844.jpg,1,0,0,0,1,0,train
1636,0509652_sc-200476.jpg,0,1,0,0,1,0,val
1637,0509613_sc-1031476.jpg,1,0,0,0,1,0,test
1638,0509616_sc-186811.jpg,17,0,3,0,20,0,train
1639,0509653_sc-200476.jpg,1,0,1,1,3,0,train
1640,0509628_sc-140410.jpg,1,0,0,1,2,0,train
1641,0509618_sc-198844.jpg,6,0,1,0,7,0,train
1642,0509634_as-7354264.jpg,1,1,0,0,2,0,train
1643,0509642_sc-1032155.jpg,0,0,0,1,1,0,val
1644,0509595_sc-221183.jpg,1,1,0,0,2,0,test
1645,0509643_sc-1032155.jpg,0,0,0,1,1,0,train
1646,0509597_sc-221183.jpg,3,3,2,1,9,0,train
1647,0509631_as-3166381.jpg,1,0,0,1,2,0,train
1648,0509607_sc-176051.jpg,2,0,0,0,2,0,train
1649,0509630_sc-215532.jpg,2,0,0,0,2,0,train
1650,0509596_sc-221183.jpg,8,0,0,0,8,0,val
1651,0509605_sc-176051.jpg,1,0,0,0,1,0,test
1652,0509639_sc-1014656.jpg,2,0,0,0,2,0,train
1653,0509622_sc-198844.jpg,0,0,1,0,1,0,train
1654,0509632_as-2554988.jpg,1,0,1,1,3,0,train
1655,0509599_as-0065844.jpg,1,1,0,1,3,0,train
1656,0509636_as-0089152.jpg,1,1,0,0,2,0,train
1657,0509649_sc-209321.jpg,2,1,0,0,3,0,val
1658,0509611_sc-139049.jpg,2,1,1,0,4,0,test
1659,0509606_sc-176051.jpg,2,2,0,0,4,0,train
1660,0509602_sc-176051.jpg,2,0,0,0,2,0,train
1661,0509638_sc-1014656.jpg,0,1,0,0,1,0,train
1662,0509627_sc-140410.jpg,1,0,2,1,4,0,train
1663,0509640_sc-1014656.jpg,2,3,0,0,5,0,train
1664,0509625_sc-140410.jpg,4,2,3,0,9,0,val
1665,0509604_sc-176051.jpg,1,0,0,0,1,0,test
1666,0509623_sc-198844.jpg,1,0,0,1,2,0,train
1667,0509629_sc-215532.jpg,4,0,0,0,4,0,train
1668,0509593_sc-221183.jpg,2,0,0,0,2,0,train
1669,0509592_sc-221183.jpg,2,3,1,2,8,0,train
1670,0509648_sc-209321.jpg,1,0,1,0,2,0,train
1671,0509650_sc-209321.jpg,7,0,2,1,10,0,val
1672,0509644_sc-1032155.jpg,0,1,1,0,2,0,test
1673,0509691_sc-196347.jpg,6,1,3,1,11,0,train
1674,0509663_sc-140591.jpg,7,0,0,0,7,0,train
1675,0509704_as-0073739.jpg,2,0,0,0,2,0,train
1676,0509674_as-0034349.jpg,1,0,0,0,1,0,train
1677,0509715_sc-144906.jpg,1,0,0,0,1,0,train
1678,0509660_sc-200476.jpg,1,0,0,0,1,0,val
1679,0509731_sc-1029266.jpg,2,0,0,1,3,0,test
1680,0509723_sc-218850.jpg,5,1,0,0,6,0,train
1681,0509711_as-2652350.jpg,0,0,1,0,1,0,train
1682,0509668_as-0085105.jpg,5,3,1,0,9,0,train
1683,0509657_sc-200476.jpg,2,0,0,0,2,0,train
1684,0509737_as-0072130.jpg,1,0,0,0,1,0,train
1685,0509681_as-0049070.jpg,0,2,0,0,2,0,val
1686,0509673_as-0034349.jpg,1,0,0,1,2,0,test
1687,0509658_sc-200476.jpg,3,2,0,0,5,0,train
1688,0509730_sc-1029266.jpg,2,1,1,0,4,0,train
1689,0509729_sc-1029266.jpg,0,0,1,0,1,0,train
1690,0509713_sc-144906.jpg,3,0,0,0,3,0,train
1691,0509686_as-2531637.jpg,4,0,1,0,5,0,train
1692,0509716_sc-144906.jpg,4,1,2,0,7,0,val
1693,0509724_sc-218850.jpg,4,0,2,1,7,0,test
1694,0509678_as-0049070.jpg,1,0,0,0,1,0,train
1695,0509736_as-0072130.jpg,2,0,0,0,2,0,train
1696,0509696_as-2990491.jpg,10,0,0,1,11,0,train
1697,0509698_as-0044064.jpg,2,0,0,0,2,0,train
1698,0509714_sc-144906.jpg,4,0,0,0,4,0,train
1699,0509656_sc-200476.jpg,1,0,0,1,2,0,val
1700,0509735_as-0072130.jpg,5,0,2,1,8,0,test
1701,0509683_as-2991854.jpg,0,1,1,0,2,0,train
1702,0509701_sc-1037374.jpg,2,0,0,0,2,0,train
1703,0509690_sc-196347.jpg,3,0,0,0,3,0,train
1704,0509705_as-0073739.jpg,0,1,0,0,1,0,train
1705,0509722_sc-218850.jpg,2,0,0,0,2,0,train
1706,0509669_as-0085105.jpg,4,0,0,0,4,0,val
1707,0509654_sc-200476.jpg,1,0,0,0,1,0,test
1708,0509739_as-0072130.jpg,2,0,0,0,2,0,train
1709,0509692_sc-196347.jpg,1,0,0,0,1,0,train
1710,0509659_sc-200476.jpg,1,0,1,0,2,0,train
1711,0509661_as-3447337.jpg,0,0,1,0,1,0,train
1712,0509679_as-0049070.jpg,3,0,1,0,4,0,train
1713,0509697_as-0044064.jpg,1,0,0,0,1,0,val
1714,0509676_as-0034349.jpg,0,0,1,0,1,0,test
1715,0509688_sc-196347.jpg,3,0,1,1,5,0,train
1716,0509706_as-0077751.jpg,3,1,0,0,4,0,train
1717,0509662_sc-140591.jpg,1,0,0,0,1,0,train
1718,0509680_as-0049070.jpg,1,0,0,0,1,0,train
1719,0509655_sc-200476.jpg,0,1,0,0,1,0,train
1720,0509720_sc-218850.jpg,1,0,0,0,1,0,val
1721,0509694_as-7892588.jpg,1,1,0,0,2,0,test
1722,0509671_as-0034349.jpg,2,0,0,0,2,0,train
1723,0509693_sc-196347.jpg,1,1,1,0,3,0,train
1724,0509725_sc-218850.jpg,1,1,0,0,2,0,train
1725,0509672_as-0034349.jpg,2,0,0,0,2,0,train
1726,0509719_sc-218850.jpg,4,0,1,0,5,0,train
1727,0509702_sc-1037374.jpg,4,0,0,0,4,0,val
1728,0509695_as-2707284.jpg,3,1,2,2,8,0,test
1729,0509699_sc-1037374.jpg,2,0,0,0,2,0,train
1730,0509685_as-0005709.jpg,1,0,0,0,1,0,train
1731,0509717_sc-144906.jpg,2,0,1,1,4,0,train
1732,0509703_as-2632279.jpg,0,0,1,0,1,0,train
1733,0509718_sc-144906.jpg,2,0,0,0,2,0,train
1734,0509689_sc-196347.jpg,0,1,0,1,2,0,val
1735,0509721_sc-218850.jpg,2,2,0,1,5,0,test
1736,0509675_as-0034349.jpg,1,0,1,1,3,0,train
1737,0509728_sc-163991.jpg,5,0,0,0,5,0,train
1738,0509670_as-0034349.jpg,3,0,0,0,3,0,train
1739,0509738_as-0072130.jpg,4,0,0,0,4,0,train
1740,0509667_as-0085105.jpg,2,0,0,0,2,0,train
1741,0509766_sc-130880.jpg,2,0,0,0,2,0,val
1742,0509748_sc-1003696.jpg,1,1,0,0,2,0,test
1743,0509763_as-3018870.jpg,1,0,0,0,1,0,train
1744,0509772_as-7289508.jpg,1,2,0,0,3,0,train
1745,0509753_as-3297265.jpg,1,0,0,0,1,0,train
1746,0509747_sc-1003696.jpg,2,2,2,0,6,0,train
1747,0509765_sc-226572.jpg,4,2,1,1,8,0,train
1748,0509770_sc-182476.jpg,2,0,0,0,2,0,val
1749,0509754_as-7433792.jpg,2,1,0,0,3,0,test
1750,0509762_as-2742915.jpg,2,0,0,0,2,0,train
1751,0509761_as-0059580.jpg,3,1,0,1,5,0,train
1752,0509749_sc-1003696.jpg,1,2,1,1,5,0,train
1753,0509759_as-0059580.jpg,3,1,0,0,4,0,train
1754,0509756_sc-107799.jpg,4,0,0,0,4,0,train
1755,0509746_sc-1003696.jpg,1,0,0,0,1,0,val
1756,0509774_sc-106014.jpg,2,0,0,0,2,0,test
1757,0509742_sc-151860.jpg,1,0,0,0,1,0,train
1758,0509741_sc-151860.jpg,0,0,1,0,1,0,train
1759,0509751_as-0029461.jpg,3,1,0,3,7,0,train
1760,0509743_sc-151860.jpg,1,2,1,0,4,0,train
1761,0509750_as-0029461.jpg,2,0,0,0,2,0,train
1762,0509745_as-2711641.jpg,0,1,1,1,3,0,val
1763,0509768_sc-1023503.jpg,1,1,0,1,3,0,test
1764,0509775_sc-106014.jpg,0,1,1,0,2,0,train
1765,0509767_sc-130880.jpg,5,1,2,1,9,0,train
1766,0509773_sc-106014.jpg,0,1,1,1,3,0,train
1767,0509771_sc-182476.jpg,7,0,0,1,8,0,train
1768,0509814_as-0009277.jpg,1,0,0,0,1,0,train
1769,0509808_sc-200534.jpg,0,1,1,0,2,0,val
1770,0509826_sc-208670.jpg,1,0,0,0,1,0,test
1771,0509844_as-0046157.jpg,1,0,0,0,1,0,train
1772,0509819_sc-199508.jpg,1,0,0,0,1,0,train
1773,0509803_sc-1013367.jpg,1,0,0,0,1,0,train
1774,0509831_sc-193491.jpg,1,0,1,1,3,0,train
1775,0509847_as-0046157.jpg,2,0,0,0,2,0,train
1776,0509838_as-0046157.jpg,0,0,1,0,1,0,val
1777,0509856_sc-195955.jpg,1,0,1,1,3,0,test
1778,0509792_as-0015227.jpg,2,0,0,0,2,0,train
1779,0509783_sc-106014.jpg,1,0,0,0,1,0,train
1780,0509811_as-7054447.jpg,0,0,1,0,1,0,train
1781,0509842_as-0046157.jpg,1,1,0,0,2,0,train
1782,0509793_as-7652342.jpg,1,0,1,0,2,0,train
1783,0509835_as-7082124.jpg,3,0,1,0,4,0,val
1784,0509789_as-0015227.jpg,0,0,1,0,1,0,test
1785,0509782_sc-106014.jpg,2,3,1,1,7,0,train
1786,0509791_as-0015227.jpg,1,0,0,0,1,0,train
1787,0509790_as-0015227.jpg,3,0,0,0,3,0,train
1788,0509852_as-0087929.jpg,5,0,0,0,5,0,train
1789,0509798_as-2991440.jpg,1,0,1,1,3,0,train
1790,0509788_as-2985956.jpg,2,0,0,0,2,0,val
1791,0509801_sc-1013367.jpg,2,0,0,0,2,0,test
1792,0509796_sc-213575.jpg,0,2,1,1,4,0,train
1793,0509778_sc-106014.jpg,1,0,1,0,2,0,train
1794,0509802_sc-1013367.jpg,1,1,1,0,3,0,train
1795,0509853_as-0087929.jpg,0,0,0,1,1,0,train
1796,0509809_sc-200534.jpg,0,0,2,0,2,0,train
1797,0509834_as-3355977.jpg,1,0,2,0,3,0,val
1798,0509804_as-3232074.jpg,0,1,0,0,1,0,test
1799,0509794_as-9057455.jpg,1,0,0,0,1,0,train
1800,0509854_as-0087929.jpg,1,0,1,0,2,0,train
1801,0509840_as-0046157.jpg,1,2,0,0,3,0,train
1802,0509818_sc-199508.jpg,1,0,1,1,3,0,train
1803,0509841_as-0046157.jpg,1,0,0,2,3,0,train
1804,0509837_as-0046157.jpg,1,0,0,0,1,0,val
1805,0509777_sc-106014.jpg,0,0,1,0,1,0,test
1806,0509807_as-7294668.jpg,1,1,2,1,5,0,train
1807,0509785_as-0063998.jpg,0,1,0,0,1,0,train
1808,0509829_sc-107784.jpg,9,0,0,0,9,0,train
1809,0509850_sc-181645.jpg,1,0,1,0,2,0,train
1810,0509828_sc-107784.jpg,1,0,0,0,1,0,train
1811,0509813_as-0009277.jpg,1,0,0,0,1,0,val
1812,0509795_sc-213575.jpg,0,0,1,0,1,0,test
1813,0509824_sc-1038872.jpg,3,0,0,0,3,0,train
1814,0509830_sc-193491.jpg,1,0,0,0,1,0,train
1815,0509855_as-0087929.jpg,1,0,0,0,1,0,train
1816,0509812_as-0009277.jpg,1,0,1,1,3,0,train
1817,0509851_as-0087929.jpg,1,0,0,0,1,0,train
1818,0509800_sc-1013367.jpg,1,0,0,0,1,0,val
1819,0509839_as-0046157.jpg,3,0,2,0,5,0,test
1820,0509823_sc-1038872.jpg,4,0,0,0,4,0,train
1821,0509820_sc-199508.jpg,4,0,1,0,5,0,train
1822,0509843_as-0046157.jpg,1,0,0,0,1,0,train
1823,0509817_sc-199508.jpg,1,0,0,0,1,0,train
1824,0509781_sc-106014.jpg,1,0,0,0,1,0,train
1825,0509833_sc-193491.jpg,3,0,0,0,3,0,val
1826,0509827_sc-107784.jpg,4,0,1,0,5,0,test
1827,0509815_sc-199508.jpg,3,0,1,0,4,0,train
1828,0509779_sc-106014.jpg,1,0,1,0,2,0,train
1829,0509784_as-0063998.jpg,0,0,2,0,2,0,train
1830,0509825_sc-208670.jpg,5,0,0,0,5,0,train
1831,0509787_as-0060234.jpg,0,0,1,1,2,0,train
1832,0509797_sc-213575.jpg,1,0,0,0,1,0,val
1833,0509821_sc-199508.jpg,2,0,0,0,2,0,test
1834,0509816_sc-199508.jpg,1,0,0,0,1,0,train
1835,0509862_as-3274160.jpg,2,0,0,0,2,0,train
1836,0509867_as-0010059.jpg,0,0,1,0,1,0,train
1837,0509909_as-0085701.jpg,1,0,0,0,1,0,train
1838,0509906_as-0085701.jpg,4,0,0,0,4,0,train
1839,0509887_sc-1026356.jpg,3,0,1,0,4,0,val
1840,0509888_sc-1026356.jpg,2,0,0,0,2,0,test
1841,0509884_sc-210078.jpg,1,0,0,1,2,0,train
1842,0509904_as-0085701.jpg,1,0,0,0,1,0,train
1843,0509914_sc-1034127.jpg,1,0,1,2,4,0,train
1844,0509903_as-0085701.jpg,0,0,0,1,1,0,train
1845,0509876_as-0016032.jpg,1,1,0,0,2,0,train
1846,0509905_as-0085701.jpg,1,0,0,0,1,0,val
1847,0509877_sc-1004296.jpg,1,0,0,1,2,0,test
1848,0509860_sc-195955.jpg,1,0,1,0,2,0,train
1849,0509869_as-0010059.jpg,1,0,0,0,1,0,train
1850,0509898_as-0085701.jpg,2,0,0,0,2,0,train
1851,0509868_as-0010059.jpg,1,0,0,0,1,0,train
1852,0509878_sc-1004296.jpg,4,0,0,0,4,0,train
1853,0509857_sc-195955.jpg,1,0,0,1,2,0,val
1854,0509882_sc-210078.jpg,4,2,0,0,6,0,test
1855,0509879_sc-210078.jpg,2,0,0,0,2,0,train
1856,0509907_as-0085701.jpg,9,0,0,3,12,0,train
1857,0509858_sc-195955.jpg,3,0,0,0,3,0,train
1858,0509891_sc-167439.jpg,1,0,0,1,2,0,train
1859,0509885_sc-210078.jpg,1,1,2,0,4,0,train
1860,0509880_sc-210078.jpg,2,0,0,0,2,0,val
1861,0509915_sc-1034127.jpg,1,0,0,0,1,0,test
1862,0509900_as-0085701.jpg,1,0,0,0,1,0,train
1863,0509875_as-0016032.jpg,4,0,0,0,4,0,train
1864,0509896_sc-112257.jpg,2,0,0,0,2,0,train
1865,0509881_sc-210078.jpg,3,0,1,1,5,0,train
1866,0509913_sc-1034127.jpg,1,1,1,1,4,0,train
1867,0509897_sc-112257.jpg,3,0,0,0,3,0,val
1868,0509901_as-0085701.jpg,3,0,2,0,5,0,test
1869,0509890_sc-167439.jpg,0,0,1,1,2,0,train
1870,0509889_sc-167439.jpg,2,1,2,0,5,0,train
1871,0509912_as-9072759.jpg,1,0,0,0,1,0,train
1872,0509866_as-0010059.jpg,1,0,0,0,1,0,train
1873,0509865_as-0010059.jpg,2,0,0,1,3,0,train
1874,0509874_as-0016032.jpg,0,2,2,0,4,0,val
1875,0509911_as-0085701.jpg,1,1,0,0,2,0,test
1876,0509864_as-0010059.jpg,1,0,1,0,2,0,train
1877,0509886_as-2995863.jpg,3,1,0,0,4,0,train
1878,0509883_sc-210078.jpg,1,0,0,0,1,0,train
1879,0509902_as-0085701.jpg,2,1,0,1,4,0,train
1880,0509917_sc-178241.jpg,0,0,1,0,1,0,train
1881,0509920_sc-178241.jpg,2,0,0,0,2,0,val
1882,0509918_sc-178241.jpg,1,0,0,0,1,0,test
1883,0509923_sc-178241.jpg,4,0,1,0,5,0,train
1884,0509919_sc-178241.jpg,1,0,0,0,1,0,train
1885,0509926_sc-178241.jpg,2,0,0,0,2,0,train
1886,0509927_sc-178241.jpg,2,0,0,0,2,0,train
1887,0509922_sc-178241.jpg,1,0,0,0,1,0,train
1888,0509924_sc-178241.jpg,2,0,0,0,2,0,val
1889,0509921_sc-178241.jpg,1,0,0,0,1,0,test
1890,0509925_sc-178241.jpg,5,0,0,0,5,0,train
1891,0509932_sc-178241.jpg,1,0,0,0,1,0,train
1892,0509928_sc-178241.jpg,2,0,0,0,2,0,train
1893,0509929_sc-178241.jpg,3,0,1,0,4,0,train
1894,0509930_sc-178241.jpg,0,1,2,0,3,0,train
1895,0509939_as-0046043.jpg,2,0,0,0,2,0,val
1896,0509934_as-0031858.jpg,2,1,1,1,5,0,test
1897,0509935_as-0067255.jpg,4,1,0,0,5,0,train
1898,0509931_sc-178241.jpg,6,0,0,0,6,0,train
1899,0509941_as-0046043.jpg,1,0,0,0,1,0,train
1900,0509938_sc-1035783.jpg,6,2,1,0,9,0,train
1901,0509942_as-0046043.jpg,1,0,0,0,1,0,train
1902,0509937_sc-1035783.jpg,5,0,0,1,6,0,val
1903,0510006_as-0087637.jpg,1,0,0,0,1,0,test
1904,0509984_as-0000866.jpg,0,0,0,2,2,0,train
1905,0509956_as-0073235.jpg,0,0,1,0,1,0,train
1906,0509957_as-0073235.jpg,3,0,0,1,4,0,train
1907,0509985_as-0000866.jpg,1,2,1,1,5,0,train
1908,0510015_as-0010068.jpg,1,0,0,0,1,0,train
1909,0509986_as-9095403.jpg,5,0,0,0,5,0,val
1910,0509964_as-0073235.jpg,0,0,1,0,1,0,test
1911,0510010_as-0055011.jpg,1,0,0,0,1,0,train
1912,0509997_sc-137043.jpg,3,0,0,2,5,0,train
1913,0509992_as-0078110.jpg,5,0,0,0,5,0,train
1914,0510005_as-0087637.jpg,2,0,0,0,2,0,train
1915,0509976_as-0073235.jpg,3,0,0,0,3,0,train
1916,0509975_as-0073235.jpg,2,0,2,0,4,0,val
1917,0510000_sc-137043.jpg,8,0,0,0,8,0,test
1918,0509970_as-0073235.jpg,6,0,3,1,10,0,train
1919,0509998_sc-137043.jpg,1,0,1,0,2,0,train
1920,0509949_sc-189975.jpg,2,0,0,0,2,0,train
1921,0510004_sc-113461.jpg,1,0,0,0,1,0,train
1922,0509971_as-0073235.jpg,1,0,0,0,1,0,train
1923,0510011_as-0055011.jpg,1,0,0,0,1,0,val
1924,0510002_sc-137043.jpg,2,1,0,2,5,0,test
1925,0509951_as-3008639.jpg,7,5,1,1,14,0,train
1926,0509965_as-0073235.jpg,1,0,0,1,2,0,train
1927,0509982_as-0000866.jpg,1,0,1,0,2,0,train
1928,0509953_as-0073235.jpg,2,0,0,0,2,0,train
1929,0509960_as-0073235.jpg,1,1,0,0,2,0,train
1930,0509995_sc-137043.jpg,3,0,1,0,4,0,val
1931,0509963_as-0073235.jpg,1,2,0,1,4,0,test
1932,0509966_as-0073235.jpg,2,0,0,1,3,0,train
1933,0509981_as-0000866.jpg,0,0,1,0,1,0,train
1934,0509968_as-0073235.jpg,1,0,0,0,1,0,train
1935,0509999_sc-137043.jpg,1,1,0,1,3,0,train
1936,0510016_sc-1021968.jpg,0,1,1,1,3,0,train
1937,0509943_as-0046043.jpg,3,0,0,0,3,0,val
1938,0509945_as-0046043.jpg,1,0,1,0,2,0,test
1939,0509958_as-0073235.jpg,2,0,0,0,2,0,train
1940,0509948_sc-189975.jpg,2,0,2,0,4,0,train
1941,0509980_as-2871966.jpg,2,0,0,0,2,0,train
1942,0509994_sc-137043.jpg,1,0,0,1,2,0,train
1943,0509977_sc-1024723.jpg,0,0,1,0,1,0,train
1944,0510001_sc-137043.jpg,2,0,0,0,2,0,val
1945,0509950_sc-189975.jpg,1,0,0,0,1,0,test
1946,0509996_sc-137043.jpg,1,1,0,0,2,0,train
1947,0509993_sc-137043.jpg,1,0,0,0,1,0,train
1948,0509955_as-0073235.jpg,1,0,1,1,3,0,train
1949,0510007_sc-1026724.jpg,2,0,0,1,3,0,train
1950,0510009_as-0055011.jpg,2,0,1,0,3,0,train
1951,0509991_as-0078110.jpg,1,0,0,1,2,0,val
1952,0509967_as-0073235.jpg,5,0,0,0,5,0,test
1953,0509944_as-0046043.jpg,4,0,1,2,7,0,train
1954,0509983_as-0000866.jpg,5,0,0,0,5,0,train
1955,0509961_as-0073235.jpg,0,2,1,0,3,0,train
1956,0509947_sc-189975.jpg,1,0,0,1,2,0,train
1957,0510064_sc-161151.jpg,2,0,0,1,3,0,train
1958,0510027_as-0009436.jpg,3,0,0,1,4,0,val
1959,0510041_as-0065202.jpg,2,1,0,0,3,0,test
1960,0510060_as-0073452.jpg,2,0,0,0,2,0,train
1961,0510036_as-0000057.jpg,1,0,2,2,5,0,train
1962,0510071_sc-161151.jpg,0,1,1,0,2,0,train
1963,0510044_as-0065202.jpg,0,0,1,0,1,0,train
1964,0510034_as-0000057.jpg,3,0,1,0,4,0,train
1965,0510050_sc-214665.jpg,1,0,0,0,1,0,val
1966,0510029_as-0000057.jpg,11,0,1,0,12,0,test
1967,0510022_as-0058323.jpg,2,0,0,0,2,0,train
1968,0510028_sc-114326.jpg,1,0,0,0,1,0,train
1969,0510038_as-0077065.jpg,1,0,0,0,1,0,train
1970,0510069_sc-161151.jpg,1,0,0,0,1,0,train
1971,0510048_sc-214665.jpg,1,0,0,0,1,0,train
1972,0510030_as-0000057.jpg,4,0,0,0,4,0,val
1973,0510020_sc-1021968.jpg,1,0,0,1,2,0,test
1974,0510033_as-0000057.jpg,3,0,0,0,3,0,train
1975,0510051_as-0067057.jpg,3,0,0,0,3,0,train
1976,0510053_as-0072737.jpg,2,0,0,0,2,0,train
1977,0510039_as-0077065.jpg,3,0,0,0,3,0,train
1978,0510068_sc-161151.jpg,1,0,1,0,2,0,train
1979,0510066_sc-161151.jpg,2,0,0,1,3,0,val
1980,0510031_as-0000057.jpg,1,0,0,0,1,0,test
1981,0510057_sc-214940.jpg,3,0,0,0,3,0,train
1982,0510062_as-0073452.jpg,3,0,0,0,3,0,train
1983,0510046_sc-203069.jpg,1,1,1,0,3,0,train
1984,0510072_as-3333480.jpg,3,1,1,0,5,0,train
1985,0510056_sc-214940.jpg,1,0,0,0,1,0,train
1986,0510023_sc-185186.jpg,5,1,0,0,6,0,val
1987,0510049_sc-214665.jpg,7,0,1,1,9,0,test
1988,0510063_sc-161151.jpg,3,0,0,0,3,0,train
1989,0510065_sc-161151.jpg,1,0,1,0,2,0,train
1990,0510045_sc-203069.jpg,2,0,2,1,5,0,train
1991,0510042_as-0065202.jpg,5,0,0,0,5,0,train
1992,0510055_as-0072737.jpg,4,2,0,0,6,0,train
1993,0510047_as-2855548.jpg,2,0,1,0,3,0,val
1994,0510024_sc-185186.jpg,1,0,0,0,1,0,test
1995,0510054_as-0072737.jpg,2,0,0,0,2,0,train
1996,0510035_as-0000057.jpg,6,0,0,0,6,0,train
1997,0510040_as-0077065.jpg,1,0,0,0,1,0,train
1998,0510032_as-0000057.jpg,1,0,0,0,1,0,train
1999,0510137_as-0079871.jpg,8,0,2,0,10,0,train
